연도,선수명,팀명,G,SBA,SB,CS,SB%,OOB,PKO
2002,김종국,KIA,133,59,50,9,84.7,0,0
2002,정수근,두산,122,54,40,14,74.1,0,0
2002,이종범,KIA,123,40,35,5,87.5,0,0
2002,전준호,현대,126,37,26,11,70.3,0,0
2002,마르티네스,LG,109,34,22,12,64.7,0,0
2002,김수연,한화,126,30,21,9,70.0,0,0
2002,유지현,LG,91,30,21,9,70.0,0,0
2002,박용택,LG,112,25,20,5,80.0,0,0
2002,정성훈,KIA,114,20,16,4,80.0,0,0
2002,이종열,LG,95,24,16,8,66.7,0,0
2002,최경환,두산,126,22,15,7,68.2,0,0
2002,김민재,SK,131,25,15,10,60.0,0,0
2002,데이비스,한화,115,23,14,9,60.9,0,0
2002,박한이,삼성,133,25,13,12,52.0,0,0
2002,이영우,한화,133,25,13,12,52.0,0,0
2002,권용관,LG,125,18,13,5,72.2,0,0
2002,박재홍,현대,112,20,12,8,60.0,0,0
2002,김응국,롯데,116,17,12,5,70.6,0,0
2002,강동우,삼성,130,17,11,6,64.7,0,0
2002,김경언,KIA,107,15,11,4,73.3,0,0
2002,김재현,LG,98,14,11,3,78.6,0,0
2002,이진영,SK,128,23,11,12,47.8,0,0
2002,전상렬,두산,125,13,10,3,76.9,0,0
2002,채종범,SK,127,19,10,9,52.6,0,0
2002,조성환,롯데,104,15,10,5,66.7,0,0
2002,이병규,LG,109,15,9,6,60.0,0,0
2002,김주찬,롯데,84,17,9,8,52.9,0,0
2002,송지만,한화,131,11,8,3,72.7,0,0
2002,송재익,SK,116,11,8,3,72.7,0,0
2002,김민호,두산,95,7,7,0,100.0,0,0
2002,이숭용,현대,125,9,7,2,77.8,0,0
2002,강석천,한화,94,10,7,3,70.0,0,0
2002,장성호,KIA,133,10,7,3,70.0,0,0
2002,홍세완,KIA,111,12,7,5,58.3,0,0
2002,신명철,롯데,81,15,7,8,46.7,0,0
2002,강봉규,두산,93,7,6,1,85.7,0,0
2002,박경완,현대,119,10,6,4,60.0,0,0
2002,정수성,현대,50,8,6,2,75.0,0,0
2002,신동주,KIA,81,8,6,2,75.0,0,0
2002,양용모,SK,74,6,6,0,100.0,0,0
2002,최태원,SK,121,9,6,3,66.7,0,0
2002,김대익,롯데,91,9,6,3,66.7,0,0
2002,박기혁,롯데,66,8,6,2,75.0,0,0
2002,박현승,롯데,94,11,6,5,54.5,0,0
2002,안경현,두산,130,9,5,4,55.6,0,0
2002,우즈,두산,119,7,5,2,71.4,0,0
2002,홍성흔,두산,127,8,5,3,62.5,0,0
2002,김재걸,삼성,83,6,5,1,83.3,0,0
2002,가르시아,한화,24,8,5,3,62.5,0,0
2002,이범호,한화,111,6,5,1,83.3,0,0
2002,장정석,KIA,75,7,5,2,71.4,0,0
2002,손지환,LG,111,7,5,2,71.4,0,0
2002,최만호,LG,93,9,5,4,55.6,0,0
2002,이호준,SK,129,8,5,3,62.5,0,0
2002,김한수,삼성,127,6,4,2,66.7,0,0
2002,박종호,현대,108,8,4,4,50.0,0,0
2002,프랭클린,현대,49,6,4,2,66.7,0,0
2002,김종석,한화,77,8,4,4,50.0,0,0
2002,조윤채,한화,21,7,4,3,57.1,0,0
2002,김창희,KIA,114,4,4,0,100.0,0,0
2002,서용빈,LG,88,8,4,4,50.0,0,0
2002,안재만,SK,5,5,4,1,80.0,0,0
2002,조원우,SK,116,7,4,3,57.1,0,0
2002,페르난데스,SK,132,8,4,4,50.0,0,0
2002,권오현,롯데,45,4,4,0,100.0,0,0
2002,김종훈,삼성,105,4,3,1,75.0,0,0
2002,박정환,삼성,119,3,3,0,100.0,0,0
2002,임재철,삼성,104,3,3,0,100.0,0,0
2002,폴,현대,113,5,3,2,60.0,0,0
2002,임수민,한화,127,9,3,6,33.3,0,0
2002,김상훈,KIA,113,4,3,1,75.0,0,0
2002,뉴선,KIA,35,4,3,1,75.0,0,0
2002,이현곤,KIA,52,3,3,0,100.0,0,0
2002,박연수,LG,60,3,3,0,100.0,0,0
2002,장재중,LG,69,3,3,0,100.0,0,0
2002,조인성,LG,124,3,3,0,100.0,0,0
2002,최동수,LG,106,4,3,1,75.0,0,0
2002,허문회,롯데,92,7,3,4,42.9,0,0
2002,강인권,두산,38,2,2,0,100.0,0,0
2002,김호,두산,91,5,2,3,40.0,0,0
2002,송원국,두산,45,2,2,0,100.0,0,0
2002,심재학,두산,119,3,2,1,66.7,0,0
2002,장원진,두산,130,4,2,2,50.0,0,0
2002,마해영,삼성,133,2,2,0,100.0,0,0
2002,양준혁,삼성,132,5,2,3,40.0,0,0
2002,박진만,현대,126,7,2,5,28.6,0,0
2002,심정수,현대,133,3,2,1,66.7,0,0
2002,최익성,현대,45,3,2,1,66.7,0,0
2002,김대원,한화,15,2,2,0,100.0,0,0
2002,김태균,한화,105,3,2,1,66.7,0,0
2002,이도형,한화,123,3,2,1,66.7,0,0
2002,장종훈,한화,101,4,2,2,50.0,0,0
2002,펨버튼,KIA,75,3,2,1,66.7,0,0
2002,심성보,LG,72,2,2,0,100.0,0,0
2002,김기태,SK,101,3,2,1,66.7,0,0
2002,양현석,SK,88,3,2,1,66.7,0,0
2002,에레라,롯데,53,7,2,5,28.6,0,0
2002,윤재국,롯데,32,2,2,0,100.0,0,0
2002,이계성,롯데,69,4,2,2,50.0,0,0
2002,이승화,롯데,49,4,2,2,50.0,0,0
2002,고영민,두산,16,2,1,1,50.0,0,0
2002,김동주,두산,120,2,1,1,50.0,0,0
2002,홍원기,두산,109,1,1,0,100.0,0,0
2002,브리또,삼성,128,3,1,2,33.3,0,0
2002,이승엽,삼성,133,3,1,2,33.3,0,0
2002,김일경,현대,57,1,1,0,100.0,0,0
2002,서성민,현대,36,1,1,0,100.0,0,0
2002,서한규,현대,86,1,1,0,100.0,0,0
2002,조재호,현대,61,3,1,2,33.3,0,0
2002,황윤성,현대,25,1,1,0,100.0,0,0
2002,조경택,한화,107,3,1,2,33.3,0,0
2002,황우구,한화,43,2,1,1,50.0,0,0
2002,김인철,KIA,37,1,1,0,100.0,0,0
2002,심제훈,KIA,4,1,1,0,100.0,0,0
2002,장일현,KIA,81,1,1,0,100.0,0,0
2002,김동수,SK,95,2,1,1,50.0,0,0
2002,김태균,롯데,67,3,1,2,33.3,0,0
2002,박남섭,롯데,29,1,1,0,100.0,0,0
2002,엄정대,롯데,51,1,1,0,100.0,0,0
2002,이대호,롯데,74,1,1,0,100.0,0,0
2002,이동욱,롯데,79,3,1,2,33.3,0,0
2002,최기문,롯데,123,5,1,4,20.0,0,0
2002,김성균,두산,3,0,0,0,-,0,0
2002,김학재,두산,2,0,0,0,-,0,0
2002,레스,두산,1,0,0,0,-,0,0
2002,문희성,두산,13,0,0,0,-,0,0
2002,유재웅,두산,52,0,0,0,-,0,0
2002,윤태수,두산,3,0,0,0,-,0,0
2002,이경환,두산,1,0,0,0,-,0,0
2002,이상훈,두산,2,0,0,0,-,0,0
2002,이재영,두산,2,0,0,0,-,0,0
2002,이종민,두산,14,0,0,0,-,0,0
2002,이혜천,두산,1,0,0,0,-,0,0
2002,진필중,두산,1,0,0,0,-,0,0
2002,차명주,두산,1,0,0,0,-,0,0
2002,강영식,삼성,1,0,0,0,-,0,0
2002,권혁,삼성,1,0,0,0,-,0,0
2002,김수관,삼성,1,0,0,0,-,0,0
2002,김승관,삼성,12,0,0,0,-,0,0
2002,김승권,삼성,59,0,0,0,-,0,0
2002,김진웅,삼성,1,0,0,0,-,0,0
2002,노병오,삼성,1,0,0,0,-,0,0
2002,노장진,삼성,3,0,0,0,-,0,0
2002,라형진,삼성,1,0,0,0,-,0,0
2002,박봉수,삼성,8,0,0,0,-,0,0
2002,손주인,삼성,1,0,0,0,-,0,0
2002,오상민,삼성,1,0,0,0,-,0,0
2002,이준민,삼성,8,0,0,0,-,0,0
2002,이태호,삼성,8,0,0,0,-,0,0
2002,임창용,삼성,2,0,0,0,-,0,0
2002,장성국,삼성,9,0,0,0,-,0,0
2002,장영균,삼성,5,0,0,0,-,0,0
2002,조동찬,삼성,5,0,0,0,-,0,0
2002,진갑용,삼성,133,0,0,0,-,0,0
2002,최형우,삼성,4,0,0,0,-,0,0
2002,하춘동,삼성,15,0,0,0,-,0,0
2002,현재윤,삼성,20,0,0,0,-,0,0
2002,강귀태,현대,74,2,0,2,0.0,0,0
2002,강병식,현대,89,2,0,2,0.0,0,0
2002,김민우,현대,25,0,0,0,-,0,0
2002,김필중,현대,3,0,0,0,-,0,0
2002,박우호,현대,12,0,0,0,-,0,0
2002,배힘찬,현대,1,0,0,0,-,0,0
2002,이대환,현대,1,0,0,0,-,0,0
2002,이용주,현대,23,0,0,0,-,0,0
2002,전근표,현대,11,0,0,0,-,0,0
2002,전준호,현대,1,0,0,0,-,0,0
2002,조승현,현대,31,0,0,0,-,0,0
2002,조용준,현대,3,0,0,0,-,0,0
2002,채종국,현대,100,2,0,2,0.0,0,0
2002,김백만,한화,3,0,0,0,-,0,0
2002,김병준,한화,1,0,0,0,-,0,0
2002,김장백,한화,1,0,0,0,-,0,0
2002,김정수,한화,5,0,0,0,-,0,0
2002,김홍집,한화,3,0,0,0,-,0,0
2002,마정길,한화,6,0,0,0,-,0,0
2002,박정진,한화,3,0,0,0,-,0,0
2002,방진호,한화,2,0,0,0,-,0,0
2002,백재호,한화,78,1,0,1,0.0,0,0
2002,서창호,한화,14,0,0,0,-,0,0
2002,송진우,한화,1,0,0,0,-,0,0
2002,송혁,한화,12,0,0,0,-,0,0
2002,신국환,한화,7,0,0,0,-,0,0
2002,이상목,한화,1,0,0,0,-,0,0
2002,임주택,한화,6,0,0,0,-,0,0
2002,정성열,한화,9,0,0,0,-,0,0
2002,조규수,한화,1,0,0,0,-,0,0
2002,조정권,한화,15,0,0,0,-,0,0
2002,조현,한화,6,0,0,0,-,0,0
2002,조현수,한화,33,0,0,0,-,0,0
2002,조효상,한화,24,0,0,0,-,0,0
2002,지승민,한화,1,0,0,0,-,0,0
2002,채상병,한화,29,0,0,0,-,0,0
2002,최영필,한화,1,0,0,0,-,0,0
2002,파라,한화,4,0,0,0,-,0,0
2002,피코타,한화,3,0,0,0,-,0,0
2002,허준,한화,103,4,0,4,0.0,0,0
2002,김민철,KIA,58,1,0,1,0.0,0,0
2002,김지영,KIA,11,0,0,0,-,0,0
2002,김지훈,KIA,49,0,0,0,-,0,0
2002,김태룡,KIA,66,1,0,1,0.0,0,0
2002,박충식,KIA,1,0,0,0,-,0,0
2002,방동민,KIA,1,0,0,0,-,0,0
2002,오우진,KIA,14,0,0,0,-,0,0
2002,이강철,KIA,2,0,0,0,-,0,0
2002,이대진,KIA,23,0,0,0,-,0,0
2002,이동수,KIA,28,0,0,0,-,0,0
2002,이재주,KIA,26,0,0,0,-,0,0
2002,조민철,KIA,12,0,0,0,-,0,0
2002,황성기,KIA,2,0,0,0,-,0,0
2002,경헌호,LG,3,0,0,0,-,0,0
2002,김상현,LG,31,0,0,0,-,0,0
2002,김용우,LG,9,0,0,0,-,0,0
2002,김우석,LG,43,1,0,1,0.0,0,0
2002,김재학,LG,12,0,0,0,-,0,0
2002,김정민,LG,32,0,0,0,-,0,0
2002,김현민,LG,16,0,0,0,-,0,0
2002,만자니오,LG,1,0,0,0,-,0,0
2002,서승화,LG,2,0,0,0,-,0,0
2002,신윤호,LG,2,0,0,0,-,0,0
2002,안상준,LG,41,1,0,1,0.0,0,0
2002,안치용,LG,1,0,0,0,-,0,0
2002,유택현,LG,3,0,0,0,-,0,0
2002,윤현식,LG,13,0,0,0,-,0,0
2002,이광우,LG,1,0,0,0,-,0,0
2002,이동현,LG,3,0,0,0,-,0,0
2002,이상훈,LG,2,0,0,0,-,0,0
2002,이일의,LG,72,1,0,1,0.0,0,0
2002,최창호,LG,2,0,0,0,-,0,0
2002,추승우,LG,6,0,0,0,-,0,0
2002,케펜,LG,1,0,0,0,-,0,0
2002,퀸란,LG,13,0,0,0,-,0,0
2002,홍현우,LG,25,1,0,1,0.0,0,0
2002,강성우,SK,62,0,0,0,-,0,0
2002,강혁,SK,31,0,0,0,-,0,0
2002,김강민,SK,1,1,0,1,0.0,0,0
2002,김동건,SK,10,0,0,0,-,0,0
2002,김재구,SK,15,0,0,0,-,0,0
2002,박계원,SK,3,0,0,0,-,0,0
2002,오승준,SK,1,0,0,0,-,0,0
2002,윤형국,SK,11,0,0,0,-,0,0
2002,이대수,SK,3,0,0,0,-,0,0
2002,잉글린,SK,78,1,0,1,0.0,0,0
2002,정경배,SK,75,1,0,1,0.0,0,0
2002,정대현,SK,1,0,0,0,-,0,0
2002,정상호,SK,28,0,0,0,-,0,0
2002,조경환,SK,93,1,0,1,0.0,0,0
2002,조동화,SK,4,0,0,0,-,0,0
2002,조웅천,SK,2,0,0,0,-,0,0
2002,채병용,SK,1,0,0,0,-,0,0
2002,김사율,롯데,1,0,0,0,-,0,0
2002,김장현,롯데,1,0,0,0,-,0,0
2002,김정현,롯데,24,3,0,3,0.0,0,0
2002,김제빈,롯데,1,0,0,0,-,0,0
2002,김풍철,롯데,1,0,0,0,-,0,0
2002,노승욱,롯데,1,0,0,0,-,0,0
2002,문규현,롯데,1,0,0,0,-,0,0
2002,박경진,롯데,39,0,0,0,-,0,0
2002,박상민,롯데,30,1,0,1,0.0,0,0
2002,박정태,롯데,103,2,0,2,0.0,0,0
2002,박종윤,롯데,10,0,0,0,-,0,0
2002,베로아,롯데,11,0,0,0,-,0,0
2002,에르난데스,롯데,1,0,0,0,-,0,0
2002,이명호,롯데,7,0,0,0,-,0,0
2002,최준석,롯데,2,0,0,0,-,0,0
2002,해처,롯데,25,0,0,0,-,0,0
2002,허일상,롯데,42,0,0,0,-,0,0
2003,이종범,KIA,132,60,50,10,83.3,0,0
2003,박용택,LG,133,54,42,12,77.8,0,0
2003,김종국,KIA,125,42,31,11,73.8,0,0
2003,마르티네스,LG,131,41,27,14,65.9,0,0
2003,김수연,한화,128,31,26,5,83.9,0,0
2003,유지현,LG,109,31,23,8,74.2,0,0
2003,조성환,롯데,129,34,23,11,67.6,0,0
2003,전준호,현대,129,29,20,9,69.0,0,0
2003,이영우,한화,133,27,18,9,66.7,0,0
2003,박한이,삼성,133,24,17,7,70.8,0,0
2003,정수근,두산,89,22,15,7,68.2,0,0
2003,박재홍,KIA,108,23,14,9,60.9,0,0
2003,김민재,SK,129,21,14,7,66.7,0,0
2003,장성호,KIA,130,17,13,4,76.5,0,0
2003,조원우,SK,128,18,13,5,72.2,0,0
2003,최경환,두산,115,14,10,4,71.4,0,0
2003,이진영,SK,128,19,10,9,52.6,0,0
2003,고지행,삼성,92,14,9,5,64.3,0,0
2003,정성훈,현대,91,13,9,4,69.2,0,0
2003,이호준,SK,133,16,9,7,56.3,0,0
2003,정경배,SK,119,12,9,3,75.0,0,0
2003,강동우,삼성,130,12,8,4,66.7,0,0
2003,이현곤,KIA,129,12,8,4,66.7,0,0
2003,송지만,한화,74,14,8,6,57.1,0,0
2003,이승엽,삼성,131,7,7,0,100.0,0,0
2003,김상현,LG,55,8,7,1,87.5,0,0
2003,이대형,LG,47,10,7,3,70.0,0,0
2003,김경언,KIA,125,14,7,7,50.0,0,0
2003,홍세완,KIA,129,14,7,7,50.0,0,0
2003,전상렬,두산,125,13,7,6,53.8,0,0
2003,김주찬,롯데,55,9,7,2,77.8,0,0
2003,박기혁,롯데,95,11,7,4,63.6,0,0
2003,박현승,롯데,118,15,7,8,46.7,0,0
2003,이시온,롯데,90,8,7,1,87.5,0,0
2003,박종호,현대,131,10,6,4,60.0,0,0
2003,박진만,현대,129,11,6,5,54.5,0,0
2003,심정수,현대,133,8,6,2,75.0,0,0
2003,프랭클린,현대,38,8,6,2,75.0,0,0
2003,박경완,SK,122,12,6,6,50.0,0,0
2003,임재철,한화,119,12,6,6,50.0,0,0
2003,한상훈,한화,95,9,6,3,66.7,0,0
2003,최기문,롯데,119,11,6,5,54.5,0,0
2003,김한수,삼성,131,7,5,2,71.4,0,0
2003,안상준,LG,73,6,5,1,83.3,0,0
2003,이종열,LG,100,8,5,3,62.5,0,0
2003,김민호,두산,77,8,5,3,62.5,0,0
2003,김창희,두산,121,8,5,3,62.5,0,0
2003,디아즈,SK,112,5,5,0,100.0,0,0
2003,송재익,SK,92,8,5,3,62.5,0,0
2003,신종길,롯데,40,7,5,2,71.4,0,0
2003,권용관,LG,78,6,4,2,66.7,0,0
2003,안치용,LG,37,4,4,0,100.0,0,0
2003,이숭용,현대,133,6,4,2,66.7,0,0
2003,안재만,SK,85,9,4,5,44.4,0,0
2003,오태근,LG,8,4,3,1,75.0,0,0
2003,김상훈,KIA,125,5,3,2,60.0,0,0
2003,장정석,KIA,86,4,3,1,75.0,0,0
2003,김동수,현대,117,7,3,4,42.9,0,0
2003,브룸바,현대,70,8,3,5,37.5,0,0
2003,조재호,현대,97,4,3,1,75.0,0,0
2003,김동주,두산,118,5,3,2,60.0,0,0
2003,김태균,한화,133,5,3,2,60.0,0,0
2003,백재호,한화,96,4,3,1,75.0,0,0
2003,김태균,롯데,101,3,3,0,100.0,0,0
2003,손인호,롯데,103,7,3,4,42.9,0,0
2003,신명철,롯데,101,10,3,7,30.0,0,0
2003,이승화,롯데,23,4,3,1,75.0,0,0
2003,김재걸,삼성,85,4,2,2,50.0,0,0
2003,브리또,삼성,102,4,2,2,50.0,0,0
2003,양준혁,삼성,133,7,2,5,28.6,0,0
2003,김용우,LG,45,3,2,1,66.7,0,0
2003,박경수,LG,84,4,2,2,50.0,0,0
2003,김인철,KIA,37,4,2,2,50.0,0,0
2003,황윤성,KIA,64,4,2,2,50.0,0,0
2003,이택근,현대,101,5,2,3,40.0,0,0
2003,정수성,현대,26,2,2,0,100.0,0,0
2003,손시헌,두산,59,2,2,0,100.0,0,0
2003,홍성흔,두산,73,4,2,2,50.0,0,0
2003,김기태,SK,93,4,2,2,50.0,0,0
2003,양현석,SK,55,2,2,0,100.0,0,0
2003,조경환,SK,121,8,2,6,25.0,0,0
2003,이범호,한화,107,8,2,6,25.0,0,0
2003,임수민,한화,106,5,2,3,40.0,0,0
2003,권오현,롯데,38,3,2,1,66.7,0,0
2003,김응국,롯데,51,4,2,2,50.0,0,0
2003,조효상,롯데,36,3,2,1,66.7,0,0
2003,페레즈,롯데,50,5,2,3,40.0,0,0
2003,강명구,삼성,9,1,1,0,100.0,0,0
2003,마해영,삼성,132,2,1,1,50.0,0,0
2003,진갑용,삼성,126,2,1,1,50.0,0,0
2003,이병규,LG,44,4,1,3,25.0,0,0
2003,최동수,LG,91,3,1,2,33.3,0,0
2003,쿡슨,LG,23,2,1,1,50.0,0,0
2003,홍현우,LG,97,2,1,1,50.0,0,0
2003,김민철,KIA,26,1,1,0,100.0,0,0
2003,김원섭,KIA,19,1,1,0,100.0,0,0
2003,신동주,KIA,95,3,1,2,33.3,0,0
2003,엄정대,KIA,22,3,1,2,33.3,0,0
2003,이재주,KIA,103,4,1,3,25.0,0,0
2003,이정상,KIA,8,1,1,0,100.0,0,0
2003,최동락,KIA,26,2,1,1,50.0,0,0
2003,허준,KIA,44,1,1,0,100.0,0,0
2003,강귀태,현대,66,2,1,1,50.0,0,0
2003,김일경,현대,80,4,1,3,25.0,0,0
2003,조승현,현대,8,1,1,0,100.0,0,0
2003,강봉규,두산,6,1,1,0,100.0,0,0
2003,고영민,두산,32,1,1,0,100.0,0,0
2003,나주환,두산,96,1,1,0,100.0,0,0
2003,심재학,두산,111,1,1,0,100.0,0,0
2003,안경현,두산,128,2,1,1,50.0,0,0
2003,이동수,두산,34,1,1,0,100.0,0,0
2003,이민택,두산,9,1,1,0,100.0,0,0
2003,이승준,두산,24,1,1,0,100.0,0,0
2003,장원진,두산,124,2,1,1,50.0,0,0
2003,강혁,SK,117,4,1,3,25.0,0,0
2003,메히아,한화,30,5,1,4,20.0,0,0
2003,장종훈,한화,83,4,1,3,25.0,0,0
2003,조윤채,한화,59,2,1,1,50.0,0,0
2003,조현수,한화,96,3,1,2,33.3,0,0
2003,황우구,한화,63,4,1,3,25.0,0,0
2003,윤재국,롯데,63,4,1,3,25.0,0,0
2003,이인구,롯데,9,2,1,1,50.0,0,0
2003,곽용섭,삼성,5,0,0,0,-,0,0
2003,권오준,삼성,1,0,0,0,-,0,0
2003,권혁,삼성,1,0,0,0,-,0,0
2003,김승관,삼성,1,0,0,0,-,0,0
2003,김종훈,삼성,88,0,0,0,-,0,0
2003,김진웅,삼성,1,0,0,0,-,0,0
2003,노장진,삼성,2,0,0,0,-,0,0
2003,라이언,삼성,1,0,0,0,-,0,0
2003,라형진,삼성,1,0,0,0,-,0,0
2003,박정환,삼성,81,0,0,0,-,0,0
2003,손주인,삼성,19,0,0,0,-,0,0
2003,심성보,삼성,38,1,0,1,0.0,0,0
2003,안지만,삼성,1,0,0,0,-,0,0
2003,이정호,삼성,1,0,0,0,-,0,0
2003,이준민,삼성,3,0,0,0,-,0,0
2003,이태호,삼성,6,0,0,0,-,0,0
2003,임창용,삼성,1,0,0,0,-,0,0
2003,장영균,삼성,1,0,0,0,-,0,0
2003,전병호,삼성,1,0,0,0,-,0,0
2003,정현욱,삼성,2,0,0,0,-,0,0
2003,조동찬,삼성,14,0,0,0,-,0,0
2003,현재윤,삼성,34,0,0,0,-,0,0
2003,경헌호,LG,2,0,0,0,-,0,0
2003,김광삼,LG,1,0,0,0,-,0,0
2003,김광희,LG,6,0,0,0,-,0,0
2003,김세중,LG,1,0,0,0,-,0,0
2003,김우석,LG,4,0,0,0,-,0,0
2003,김재학,LG,2,0,0,0,-,0,0
2003,김재현,LG,50,0,0,0,-,0,0
2003,김정민,LG,9,0,0,0,-,0,0
2003,김진유,LG,1,0,0,0,-,0,0
2003,박만채,LG,3,0,0,0,-,0,0
2003,박용진,LG,1,0,0,0,-,0,0
2003,서승화,LG,8,0,0,0,-,0,0
2003,성영재,LG,1,0,0,0,-,0,0
2003,손지환,LG,61,2,0,2,0.0,0,0
2003,알칸트라,LG,79,1,0,1,0.0,0,0
2003,유택현,LG,4,0,0,0,-,0,0
2003,윤현식,LG,5,1,0,1,0.0,0,0
2003,이동현,LG,1,0,0,0,-,0,0
2003,이상훈,LG,7,0,0,0,-,0,0
2003,이승호,LG,1,0,0,0,-,0,0
2003,이일의,LG,2,0,0,0,-,0,0
2003,장문석,LG,3,0,0,0,-,0,0
2003,장재중,LG,57,0,0,0,-,0,0
2003,전승남,LG,4,0,0,0,-,0,0
2003,조인성,LG,132,1,0,1,0.0,0,0
2003,최만호,LG,93,2,0,2,0.0,0,0
2003,추승우,LG,5,0,0,0,-,0,0
2003,허문회,LG,23,0,0,0,-,0,0
2003,고우석,KIA,1,0,0,0,-,0,0
2003,김경진,KIA,18,0,0,0,-,0,0
2003,김주호,KIA,31,0,0,0,-,0,0
2003,김지훈,KIA,39,0,0,0,-,0,0
2003,리오스,KIA,1,0,0,0,-,0,0
2003,서동욱,KIA,42,1,0,1,0.0,0,0
2003,신용운,KIA,4,0,0,0,-,0,0
2003,오봉옥,KIA,2,0,0,0,-,0,0
2003,오우진,KIA,2,0,0,0,-,0,0
2003,오철민,KIA,3,0,0,0,-,0,0
2003,유동훈,KIA,1,0,0,0,-,0,0
2003,이강철,KIA,2,0,0,0,-,0,0
2003,임준혁,KIA,5,0,0,0,-,0,0
2003,정원,KIA,1,0,0,0,-,0,0
2003,조민철,KIA,5,0,0,0,-,0,0
2003,존슨,KIA,1,0,0,0,-,0,0
2003,진필중,KIA,1,0,0,0,-,0,0
2003,차일목,KIA,6,0,0,0,-,0,0
2003,강병식,현대,43,1,0,1,0.0,0,0
2003,권준헌,현대,2,0,0,0,-,0,0
2003,김민우,현대,15,1,0,1,0.0,0,0
2003,김성태,현대,3,0,0,0,-,0,0
2003,마일영,현대,1,0,0,0,-,0,0
2003,서한규,현대,35,0,0,0,-,0,0
2003,신철인,현대,2,0,0,0,-,0,0
2003,이대환,현대,3,0,0,0,-,0,0
2003,이상열,현대,1,0,0,0,-,0,0
2003,전근표,현대,61,0,0,0,-,0,0
2003,조용준,현대,3,0,0,0,-,0,0
2003,채종국,현대,90,0,0,0,-,0,0
2003,최익성,현대,33,0,0,0,-,0,0
2003,황두성,현대,1,0,0,0,-,0,0
2003,강인권,두산,67,3,0,3,0.0,0,0
2003,구자운,두산,1,0,0,0,-,0,0
2003,문희성,두산,71,1,0,1,0.0,0,0
2003,백대운,두산,9,0,0,0,-,0,0
2003,백승훈,두산,2,0,0,0,-,0,0
2003,윤태수,두산,6,0,0,0,-,0,0
2003,이경환,두산,21,0,0,0,-,0,0
2003,이리키,두산,2,0,0,0,-,0,0
2003,이재영,두산,3,0,0,0,-,0,0
2003,정종수,두산,17,0,0,0,-,0,0
2003,쿨바,두산,44,0,0,0,-,0,0
2003,키퍼,두산,1,0,0,0,-,0,0
2003,홍원기,두산,124,3,0,3,0.0,0,0
2003,강성우,SK,39,0,0,0,-,0,0
2003,김강민,SK,2,0,0,0,-,0,0
2003,김동건,SK,2,0,0,0,-,0,0
2003,김명완,SK,1,0,0,0,-,0,0
2003,김형철,SK,2,0,0,0,-,0,0
2003,박두일,SK,1,0,0,0,-,0,0
2003,송수근,SK,2,0,0,0,-,0,0
2003,송은범,SK,1,0,0,0,-,0,0
2003,윤길현,SK,1,0,0,0,-,0,0
2003,윤형국,SK,4,0,0,0,-,0,0
2003,이대수,SK,10,0,0,0,-,0,0
2003,정상호,SK,21,0,0,0,-,0,0
2003,조웅천,SK,2,0,0,0,-,0,0
2003,조중근,SK,11,0,0,0,-,0,0
2003,채종범,SK,94,0,0,0,-,0,0
2003,최태원,SK,33,1,0,1,0.0,0,0
2003,강석천,한화,8,0,0,0,-,0,0
2003,기론,한화,1,0,0,0,-,0,0
2003,김무성,한화,2,0,0,0,-,0,0
2003,김승권,한화,36,1,0,1,0.0,0,0
2003,김종석,한화,78,3,0,3,0.0,0,0
2003,김홍집,한화,1,0,0,0,-,0,0
2003,마정길,한화,3,0,0,0,-,0,0
2003,맹진국,한화,9,0,0,0,-,0,0
2003,박정진,한화,3,0,0,0,-,0,0
2003,송진우,한화,2,0,0,0,-,0,0
2003,송혁,한화,2,0,0,0,-,0,0
2003,신민기,한화,21,0,0,0,-,0,0
2003,심광호,한화,41,0,0,0,-,0,0
2003,안영명,한화,5,0,0,0,-,0,0
2003,이도형,한화,125,1,0,1,0.0,0,0
2003,이상목,한화,1,0,0,0,-,0,0
2003,이양기,한화,1,0,0,0,-,0,0
2003,정성열,한화,8,0,0,0,-,0,0
2003,조경택,한화,48,0,0,0,-,0,0
2003,조규수,한화,2,0,0,0,-,0,0
2003,조정권,한화,14,0,0,0,-,0,0
2003,채상병,한화,25,0,0,0,-,0,0
2003,피코타,한화,9,0,0,0,-,0,0
2003,한용덕,한화,2,0,0,0,-,0,0
2003,강상수,롯데,2,0,0,0,-,0,0
2003,김대익,롯데,48,1,0,1,0.0,0,0
2003,김영화,롯데,7,0,0,0,-,0,0
2003,문규현,롯데,17,0,0,0,-,0,0
2003,박경진,롯데,10,0,0,0,-,0,0
2003,박남섭,롯데,29,1,0,1,0.0,0,0
2003,박연수,롯데,72,3,0,3,0.0,0,0
2003,박정준,롯데,1,0,0,0,-,0,0
2003,박정태,롯데,50,1,0,1,0.0,0,0
2003,변인재,롯데,1,0,0,0,-,0,0
2003,보이,롯데,7,0,0,0,-,0,0
2003,이계성,롯데,59,1,0,1,0.0,0,0
2003,이대호,롯데,54,2,0,2,0.0,0,0
2003,이동욱,롯데,21,1,0,1,0.0,0,0
2003,이정훈,롯데,2,0,0,0,-,0,0
2003,임경완,롯데,1,0,0,0,-,0,0
2003,정보명,롯데,2,0,0,0,-,0,0
2003,허일상,롯데,58,0,0,0,-,0,0
2004,전준호,현대,132,60,53,7,88.3,0,0
2004,김주찬,롯데,120,54,44,10,81.5,0,0
2004,이종범,KIA,133,49,42,7,85.7,0,0
2004,김종국,KIA,133,47,39,8,83.0,0,0
2004,정수근,롯데,92,29,24,5,82.8,0,0
2004,이영우,한화,131,32,20,12,62.5,0,0
2004,김수연,한화,115,28,17,11,60.7,0,0
2004,전상렬,두산,128,22,15,7,68.2,0,0
2004,최경환,두산,126,22,14,8,63.6,0,0
2004,정수성,현대,88,13,13,0,100.0,0,0
2004,박한이,삼성,132,22,13,9,59.1,0,0
2004,김민재,SK,129,14,11,3,78.6,0,0
2004,장성호,KIA,130,18,11,7,61.1,0,0
2004,박기혁,롯데,131,15,11,4,73.3,0,0
2004,박용택,LG,109,14,10,4,71.4,0,0
2004,홍성흔,두산,133,17,10,7,58.8,0,0
2004,강동우,삼성,132,14,9,5,64.3,0,0
2004,데이비스,한화,119,14,9,5,64.3,0,0
2004,권용관,LG,124,14,9,5,64.3,0,0
2004,이진영,SK,117,14,8,6,57.1,0,0
2004,홍세완,KIA,96,12,8,4,66.7,0,0
2004,고동진,한화,51,10,8,2,80.0,0,0
2004,이병규,LG,129,12,8,4,66.7,0,0
2004,안경현,두산,125,11,8,3,72.7,0,0
2004,브룸바,현대,132,15,7,8,46.7,0,0
2004,이호준,SK,133,14,7,7,50.0,0,0
2004,박재홍,KIA,73,12,7,5,58.3,0,0
2004,박종호,삼성,132,9,7,2,77.8,0,0
2004,김상현,LG,100,12,7,5,58.3,0,0
2004,마틴,LG,107,7,7,0,100.0,0,0
2004,박경수,LG,92,13,7,6,53.8,0,0
2004,최기문,롯데,108,13,7,6,53.8,0,0
2004,페레즈,롯데,125,13,7,6,53.8,0,0
2004,박진만,현대,129,9,6,3,66.7,0,0
2004,송지만,현대,132,13,6,7,46.2,0,0
2004,김경언,KIA,114,8,6,2,75.0,0,0
2004,이범호,한화,133,9,6,3,66.7,0,0
2004,최만호,LG,112,10,6,4,60.0,0,0
2004,신명철,롯데,54,8,6,2,75.0,0,0
2004,조원우,SK,119,11,5,6,45.5,0,0
2004,김대익,삼성,93,6,5,1,83.3,0,0
2004,김종훈,삼성,127,7,5,2,71.4,0,0
2004,양준혁,삼성,133,7,5,2,71.4,0,0
2004,오태근,LG,46,8,5,3,62.5,0,0
2004,장원진,두산,130,13,5,8,38.5,0,0
2004,박남섭,롯데,86,6,5,1,83.3,0,0
2004,채종국,현대,128,8,4,4,50.0,0,0
2004,조경환,SK,92,5,4,1,80.0,0,0
2004,마해영,KIA,124,7,4,3,57.1,0,0
2004,신종길,한화,49,8,4,4,50.0,0,0
2004,김동주,두산,124,10,4,6,40.0,0,0
2004,윤재국,두산,28,9,4,5,44.4,0,0
2004,정원석,두산,54,8,4,4,50.0,0,0
2004,이대호,롯데,132,7,4,3,57.1,0,0
2004,김일경,현대,83,4,3,1,75.0,0,0
2004,손지환,KIA,114,6,3,3,50.0,0,0
2004,이현곤,KIA,68,3,3,0,100.0,0,0
2004,조동찬,삼성,123,3,3,0,100.0,0,0
2004,신경현,한화,97,7,3,4,42.9,0,0
2004,라이온,롯데,102,4,3,1,75.0,0,0
2004,손인호,롯데,122,5,3,2,60.0,0,0
2004,조성환,롯데,19,3,3,0,100.0,0,0
2004,김동수,현대,113,4,2,2,50.0,0,0
2004,김강민,SK,23,3,2,1,66.7,0,0
2004,김기태,SK,126,6,2,4,33.3,0,0
2004,박경완,SK,132,7,2,5,28.6,0,0
2004,안재만,SK,73,3,2,1,66.7,0,0
2004,정경배,SK,105,6,2,4,33.3,0,0
2004,채종범,SK,104,7,2,5,28.6,0,0
2004,김상훈,KIA,128,3,2,1,66.7,0,0
2004,김재걸,삼성,64,5,2,3,40.0,0,0
2004,현재윤,삼성,77,5,2,3,40.0,0,0
2004,김태균,한화,129,3,2,1,66.7,0,0
2004,디아즈,한화,70,7,2,5,28.6,0,0
2004,엔젤,한화,40,2,2,0,100.0,0,0
2004,최민준,한화,14,2,2,0,100.0,0,0
2004,최진행,한화,79,2,2,0,100.0,0,0
2004,이대형,LG,13,3,2,1,66.7,0,0
2004,이종열,LG,106,6,2,4,33.3,0,0
2004,조인성,LG,129,7,2,5,28.6,0,0
2004,강봉규,두산,40,3,2,1,66.7,0,0
2004,김창희,두산,110,5,2,3,40.0,0,0
2004,박현승,롯데,61,3,2,1,66.7,0,0
2004,서정호,롯데,15,2,2,0,100.0,0,0
2004,강귀태,현대,84,3,1,2,33.3,0,0
2004,강병식,현대,16,1,1,0,100.0,0,0
2004,김민우,현대,18,1,1,0,100.0,0,0
2004,서한규,현대,72,1,1,0,100.0,0,0
2004,정성훈,현대,118,4,1,3,25.0,0,0
2004,조재호,현대,87,1,1,0,100.0,0,0
2004,김형철,SK,23,1,1,0,100,0,0
2004,송재익,SK,68,2,1,1,50.0,0,0
2004,조중근,SK,41,1,1,0,100,0,0
2004,서동욱,KIA,58,3,1,2,33.3,0,0
2004,심재학,KIA,128,5,1,4,20.0,0,0
2004,김한수,삼성,133,3,1,2,33.3,0,0
2004,신동주,삼성,73,3,1,2,33.3,0,0
2004,맹진국,한화,5,1,1,0,100,0,0
2004,박노민,한화,4,1,1,0,100,0,0
2004,임수민,한화,111,3,1,2,33.3,0,0
2004,조현수,한화,92,2,1,1,50.0,0,0
2004,한상훈,한화,63,3,1,2,33.3,0,0
2004,김재현,LG,120,2,1,1,50.0,0,0
2004,안치용,LG,22,1,1,0,100,0,0
2004,이용규,LG,52,4,1,3,25.0,0,0
2004,최동수,LG,123,2,1,1,50.0,0,0
2004,나주환,두산,64,2,1,1,50.0,0,0
2004,유재웅,두산,76,3,1,2,33.3,0,0
2004,이승준,두산,64,1,1,0,100,0,0
2004,박경진,롯데,35,1,1,0,100,0,0
2004,박연수,롯데,74,1,1,0,100,0,0
2004,박정준,롯데,16,1,1,0,100,0,0
2004,이계성,롯데,54,1,1,0,100,0,0
2004,이인구,롯데,41,1,1,0,100,0,0
2004,김성태,현대,1,0,0,0,-,0,0
2004,송신영,현대,1,0,0,0,-,0,0
2004,신철인,현대,3,0,0,0,-,0,0
2004,심정수,현대,102,1,0,1,0.0,0,0
2004,이상열,현대,1,0,0,0,-,0,0
2004,이숭용,현대,133,3,0,3,0.0,0,0
2004,이택근,현대,41,2,0,2,0.0,0,0
2004,전근표,현대,79,2,0,2,0.0,0,0
2004,조용준,현대,3,0,0,0,-,0,0
2004,지석훈,현대,5,0,0,0,-,0,0
2004,강성우,SK,30,0,0,0,-,0,0
2004,강혁,SK,88,0,0,0,-,0,0
2004,고효준,SK,1,0,0,0,-,0,0
2004,김건한,SK,1,0,0,0,-,0,0
2004,김경태,SK,1,0,0,0,-,0,0
2004,김영수,SK,2,0,0,0,-,0,0
2004,김원,SK,5,0,0,0,-,0,0
2004,김원형,SK,1,0,0,0,-,0,0
2004,박정권,SK,24,0,0,0,-,0,0
2004,박창근,SK,3,0,0,0,-,0,0
2004,브리또,SK,102,2,0,2,0.0,0,0
2004,송수근,SK,28,0,0,0,-,0,0
2004,송은범,SK,1,0,0,0,-,0,0
2004,신승현,SK,1,0,0,0,-,0,0
2004,신주일,SK,1,0,0,0,-,0,0
2004,양승학,SK,2,0,0,0,-,0,0
2004,엄정욱,SK,1,0,0,0,-,0,0
2004,윤현식,SK,4,0,0,0,-,0,0
2004,윤형국,SK,10,0,0,0,-,0,0
2004,이대수,SK,105,1,0,1,0.0,0,0
2004,이상훈,SK,3,0,0,0,-,0,0
2004,임훈,SK,10,0,0,0,-,0,0
2004,정대현,SK,3,0,0,0,-,0,0
2004,조웅천,SK,4,0,0,0,-,0,0
2004,최경철,SK,34,0,0,0,-,0,0
2004,카브레라,SK,7,0,0,0,-,0,0
2004,고우석,KIA,1,0,0,0,-,0,0
2004,김경진,KIA,66,1,0,1,0.0,0,0
2004,김민철,KIA,11,0,0,0,-,0,0
2004,김원섭,KIA,41,3,0,3,0.0,0,0
2004,김인철,KIA,3,0,0,0,-,0,0
2004,김주형,KIA,47,1,0,1,0.0,0,0
2004,김주호,KIA,27,1,0,1,0.0,0,0
2004,김지훈,KIA,55,0,0,0,-,0,0
2004,마뇽,KIA,2,0,0,0,-,0,0
2004,신용운,KIA,2,0,0,0,-,0,0
2004,오철민,KIA,1,0,0,0,-,0,0
2004,이강철,KIA,3,0,0,0,-,0,0
2004,이경원,KIA,2,0,0,0,-,0,0
2004,이동현,KIA,1,0,0,0,-,0,0
2004,이재주,KIA,119,2,0,2,0.0,0,0
2004,이정상,KIA,6,0,0,0,-,0,0
2004,최용호,KIA,1,0,0,0,-,0,0
2004,최향남,KIA,1,0,0,0,-,0,0
2004,허준,KIA,11,0,0,0,-,0,0
2004,강명구,삼성,15,1,0,1,0.0,0,0
2004,강영식,삼성,1,0,0,0,-,0,0
2004,고지행,삼성,2,0,0,0,-,0,0
2004,곽용섭,삼성,1,0,0,0,-,0,0
2004,권오준,삼성,2,0,0,0,-,0,0
2004,권혁,삼성,2,0,0,0,-,0,0
2004,김덕윤,삼성,3,0,0,0,-,0,0
2004,김영복,삼성,4,0,0,0,-,0,0
2004,김진웅,삼성,1,0,0,0,-,0,0
2004,김현욱,삼성,1,0,0,0,-,0,0
2004,로페즈,삼성,22,0,0,0,-,0,0
2004,박석민,삼성,23,0,0,0,-,0,0
2004,박석진,삼성,2,0,0,0,-,0,0
2004,박정환,삼성,29,1,0,1,0.0,0,0
2004,배영수,삼성,2,0,0,0,-,0,0
2004,안지만,삼성,1,0,0,0,-,0,0
2004,오리어리,삼성,63,0,0,0,-,0,0
2004,오상민,삼성,1,0,0,0,-,0,0
2004,윤성환,삼성,3,0,0,0,-,0,0
2004,이정식,삼성,32,0,0,0,-,0,0
2004,이태호,삼성,11,0,0,0,-,0,0
2004,임창용,삼성,6,0,0,0,-,0,0
2004,정현욱,삼성,2,0,0,0,-,0,0
2004,진갑용,삼성,129,0,0,0,-,0,0
2004,최익성,삼성,18,0,0,0,-,0,0
2004,최형우,삼성,2,0,0,0,-,0,0
2004,고상천,한화,1,0,0,0,-,0,0
2004,권영근,한화,5,0,0,0,-,0,0
2004,권준헌,한화,5,0,0,0,-,0,0
2004,김승권,한화,28,1,0,1,0.0,0,0
2004,김종석,한화,21,0,0,0,-,0,0
2004,김해님,한화,1,0,0,0,-,0,0
2004,문용민,한화,1,0,0,0,-,0,0
2004,박정진,한화,4,0,0,0,-,0,0
2004,백재호,한화,69,0,0,0,-,0,0
2004,송창식,한화,1,0,0,0,-,0,0
2004,신주영,한화,1,0,0,0,-,0,0
2004,심광호,한화,52,1,0,1,0.0,0,0
2004,안영명,한화,2,0,0,0,-,0,0
2004,오봉옥,한화,1,0,0,0,-,0,0
2004,윤경희,한화,1,0,0,0,-,0,0
2004,윤규진,한화,1,0,0,0,-,0,0
2004,이도형,한화,66,0,0,0,-,0,0
2004,이상현,한화,2,0,0,0,-,0,0
2004,이송영,한화,1,0,0,0,-,0,0
2004,이양기,한화,10,0,0,0,-,0,0
2004,이창훈,한화,25,1,0,1,0.0,0,0
2004,장종훈,한화,70,1,0,1,0.0,0,0
2004,정병희,한화,3,0,0,0,-,0,0
2004,조문기,한화,1,0,0,0,-,0,0
2004,조영민,한화,1,0,0,0,-,0,0
2004,조윤채,한화,14,0,0,0,-,0,0
2004,지연규,한화,4,0,0,0,-,0,0
2004,차명주,한화,2,0,0,0,-,0,0
2004,최영필,한화,2,0,0,0,-,0,0
2004,황우구,한화,29,1,0,1,0.0,0,0
2004,경헌호,LG,1,0,0,0,-,0,0
2004,김광삼,LG,1,0,0,0,-,0,0
2004,김광우,LG,1,0,0,0,-,0,0
2004,김용우,LG,11,0,0,0,-,0,0
2004,김우석,LG,43,0,0,0,-,0,0
2004,김재학,LG,4,0,0,0,-,0,0
2004,김정민,LG,61,1,0,1,0.0,0,0
2004,김태완,LG,15,0,0,0,-,0,0
2004,류택현,LG,1,0,0,0,-,0,0
2004,민경수,LG,3,0,0,0,-,0,0
2004,박기남,LG,38,0,0,0,-,0,0
2004,서승화,LG,2,0,0,0,-,0,0
2004,신윤호,LG,1,0,0,0,-,0,0
2004,심수창,LG,1,0,0,0,-,0,0
2004,안상준,LG,14,0,0,0,-,0,0
2004,양현석,LG,52,0,0,0,-,0,0
2004,우규민,LG,1,0,0,0,-,0,0
2004,유지현,LG,16,0,0,0,-,0,0
2004,이동현,LG,1,0,0,0,-,0,0
2004,이성열,LG,1,0,0,0,-,0,0
2004,이학준,LG,4,0,0,0,-,0,0
2004,장문석,LG,1,0,0,0,-,0,0
2004,장준관,LG,1,0,0,0,-,0,0
2004,전승남,LG,1,0,0,0,-,0,0
2004,정재복,LG,1,0,0,0,-,0,0
2004,진필중,LG,5,0,0,0,-,0,0
2004,최길성,LG,16,0,0,0,-,0,0
2004,최승환,LG,7,0,0,0,-,0,0
2004,한규식,LG,45,1,0,1,0.0,0,0
2004,허용,LG,1,0,0,0,-,0,0
2004,홍현우,LG,39,0,0,0,-,0,0
2004,강인권,두산,79,0,0,0,-,0,0
2004,구자운,두산,4,0,0,0,-,0,0
2004,김재호,두산,36,0,0,0,-,0,0
2004,레스,두산,1,0,0,0,-,0,0
2004,문희성,두산,28,0,0,0,-,0,0
2004,방승재,두산,10,0,0,0,-,0,0
2004,백승훈,두산,5,1,0,1,0.0,0,0
2004,손시헌,두산,122,2,0,2,0.0,0,0
2004,알칸트라,두산,37,1,0,1,0.0,0,0
2004,용덕한,두산,5,0,0,0,-,0,0
2004,윤상무,두산,3,0,0,0,-,0,0
2004,윤석민,두산,3,0,0,0,-,0,0
2004,이재영,두산,3,0,0,0,-,0,0
2004,이혜천,두산,1,0,0,0,-,0,0
2004,임재철,두산,51,1,0,1,0.0,0,0
2004,전병두,두산,1,0,0,0,-,0,0
2004,정성훈,두산,7,0,0,0,-,0,0
2004,정재훈,두산,3,0,0,0,-,0,0
2004,채상병,두산,15,0,0,0,-,0,0
2004,홍마태,두산,6,0,0,0,-,0,0
2004,홍원기,두산,101,0,0,0,-,0,0
2004,황윤성,두산,3,0,0,0,-,0,0
2004,가득염,롯데,3,0,0,0,-,0,0
2004,강민호,롯데,3,0,0,0,-,0,0
2004,강상수,롯데,4,0,0,0,-,0,0
2004,김만윤,롯데,7,1,0,1,0.0,0,0
2004,김승관,롯데,59,1,0,1,0.0,0,0
2004,김종성,롯데,2,0,0,0,-,0,0
2004,김태균,롯데,40,0,0,0,-,0,0
2004,노승욱,롯데,2,0,0,0,-,0,0
2004,노장진,롯데,4,0,0,0,-,0,0
2004,문규현,롯데,8,1,0,1,0.0,0,0
2004,박정태,롯데,26,0,0,0,-,0,0
2004,박진환,롯데,23,0,0,0,-,0,0
2004,성민국,롯데,4,0,0,0,-,0,0
2004,손민한,롯데,5,0,0,0,-,0,0
2004,심제훈,롯데,3,0,0,0,-,0,0
2004,이시온,롯데,4,0,0,0,-,0,0
2004,이정민,롯데,1,0,0,0,-,0,0
2004,이정훈,롯데,4,0,0,0,-,0,0
2004,임경완,롯데,4,0,0,0,-,0,0
2004,장원준,롯데,1,0,0,0,-,0,0
2004,조인신,롯데,22,0,0,0,-,0,0
2004,조효상,롯데,10,0,0,0,-,0,0
2004,최대성,롯데,1,0,0,0,-,0,0
2004,최준석,롯데,10,0,0,0,-,0,0
2004,허일상,롯데,27,1,0,1,0.0,0,0
2004,황이갑,롯데,5,0,0,0,-,0,0
2005,박용택,LG,126,50,43,7,86.0,0,0
2005,윤승균,두산,116,51,39,12,76.5,0,0
2005,이대형,LG,107,46,37,9,80.4,0,0
2005,이용규,KIA,124,41,31,10,75.6,0,0
2005,정수성,현대,118,34,29,5,85.3,0,0
2005,이종범,KIA,118,33,28,5,84.8,0,0
2005,박재홍,SK,109,32,22,10,68.8,0,0
2005,강명구,삼성,106,23,21,2,91.3,0,0
2005,신명철,롯데,116,29,21,8,72.4,0,0
2005,정수근,롯데,109,36,21,15,58.3,0,0
2005,김민재,SK,125,25,20,5,80.0,0,0
2005,조동화,SK,110,24,19,5,79.2,0,0
2005,클리어,LG,110,24,19,5,79.2,0,0
2005,전준호,현대,94,26,18,8,69.2,0,0
2005,조동찬,삼성,122,23,17,6,73.9,0,0
2005,안재만,LG,65,21,15,6,71.4,0,0
2005,박한이,삼성,123,22,12,10,54.5,0,0
2005,문희성,두산,114,15,12,3,80.0,0,0
2005,최경환,두산,102,15,11,4,73.3,0,0
2005,김민철,KIA,101,15,11,4,73.3,0,0
2005,김종국,KIA,117,16,11,5,68.8,0,0
2005,고동진,한화,94,14,11,3,78.6,0,0
2005,양준혁,삼성,124,13,10,3,76.9,0,0
2005,임재철,두산,109,13,10,3,76.9,0,0
2005,이병규,LG,119,16,10,6,62.5,0,0
2005,서한규,현대,93,11,9,2,81.8,0,0
2005,강동우,삼성,125,10,9,1,90.0,0,0
2005,김수연,한화,111,12,9,3,75.0,0,0
2005,김재걸,삼성,103,16,8,8,50.0,0,0
2005,나주환,두산,99,11,8,3,72.7,0,0
2005,이진영,SK,122,13,8,5,61.5,0,0
2005,김인철,한화,103,11,8,3,72.7,0,0
2005,박기혁,롯데,114,11,8,3,72.7,0,0
2005,정성훈,현대,126,10,7,3,70.0,0,0
2005,홍세완,KIA,90,14,7,7,50.0,0,0
2005,정경배,SK,126,15,7,8,46.7,0,0
2005,데이비스,한화,118,10,7,3,70.0,0,0
2005,조원우,한화,95,10,7,3,70.0,0,0
2005,라이온,롯데,125,10,7,3,70.0,0,0
2005,이범호,한화,126,8,6,2,75.0,0,0
2005,박정준,롯데,91,10,6,4,60.0,0,0
2005,박종호,삼성,119,7,5,2,71.4,0,0
2005,박진만,삼성,85,7,5,2,71.4,0,0
2005,이호준,SK,105,10,5,5,50.0,0,0
2005,이종열,LG,85,6,5,1,83.3,0,0
2005,백재호,한화,85,5,5,0,100.0,0,0
2005,김일경,현대,55,4,4,0,100.0,0,0
2005,김창희,두산,84,6,4,2,66.7,0,0
2005,장원진,두산,123,8,4,4,50.0,0,0
2005,장성호,KIA,123,5,4,1,80.0,0,0
2005,정근우,SK,52,6,4,2,66.7,0,0
2005,박남섭,롯데,68,6,4,2,66.7,0,0
2005,최준석,롯데,100,5,4,1,80.0,0,0
2005,송지만,현대,123,6,3,3,50.0,0,0
2005,김종훈,삼성,70,4,3,1,75.0,0,0
2005,심정수,삼성,124,5,3,2,60.0,0,0
2005,전상렬,두산,92,6,3,3,50.0,0,0
2005,심재학,KIA,94,4,3,1,75.0,0,0
2005,박재상,SK,31,4,3,1,75.0,0,0
2005,최익성,SK,40,3,3,0,100.0,0,0
2005,권용관,LG,79,5,3,2,60.0,0,0
2005,이성열,LG,102,4,3,1,75.0,0,0
2005,이학준,LG,13,3,3,0,100.0,0,0
2005,정의윤,LG,106,4,3,1,75.0,0,0
2005,김태균,한화,124,4,3,1,75.0,0,0
2005,박진환,롯데,31,5,3,2,60.0,0,0
2005,손인호,롯데,114,5,3,2,60.0,0,0
2005,최기문,롯데,94,4,3,1,75.0,0,0
2005,펠로우,롯데,109,7,3,4,42.9,0,0
2005,강귀태,현대,104,2,2,0,100.0,0,0
2005,강병식,현대,94,2,2,0,100.0,0,0
2005,김동수,현대,96,3,2,1,66.7,0,0
2005,이택근,현대,71,3,2,1,66.7,0,0
2005,강봉규,두산,48,3,2,1,66.7,0,0
2005,손시헌,두산,126,7,2,5,28.6,0,0
2005,홍성흔,두산,115,4,2,2,50.0,0,0
2005,김경언,KIA,78,4,2,2,50.0,0,0
2005,송산,KIA,75,4,2,2,50.0,0,0
2005,김강민,SK,23,5,2,3,40.0,0,0
2005,김재현,SK,120,4,2,2,50.0,0,0
2005,조중근,SK,108,4,2,2,50.0,0,0
2005,마테오,LG,34,3,2,1,66.7,0,0
2005,안상준,LG,26,2,2,0,100.0,0,0
2005,신경현,한화,110,5,2,3,40.0,0,0
2005,유한준,현대,18,1,1,0,100.0,0,0
2005,이숭용,현대,105,2,1,1,50.0,0,0
2005,채종국,현대,106,9,1,8,11.1,0,0
2005,김한수,삼성,114,1,1,0,100.0,0,0
2005,박석민,삼성,52,1,1,0,100.0,0,0
2005,박정환,삼성,26,1,1,0,100.0,0,0
2005,진갑용,삼성,110,2,1,1,50.0,0,0
2005,김동주,두산,94,3,1,2,33.3,0,0
2005,김재호,두산,47,1,1,0,100,0,0
2005,방승재,두산,6,1,1,0,100,0,0
2005,안경현,두산,105,3,1,2,33.3,0,0
2005,용덕한,두산,59,4,1,3,25.0,0,0
2005,정원석,두산,15,2,1,1,50.0,0,0
2005,손지환,KIA,107,3,1,2,33.3,0,0
2005,최훈락,KIA,24,2,1,1,50.0,0,0
2005,김태균,SK,110,1,1,0,100,0,0
2005,박경완,SK,114,5,1,4,20.0,0,0
2005,이대수,SK,99,2,1,1,50.0,0,0
2005,박경수,LG,35,1,1,0,100,0,0
2005,박병호,LG,79,1,1,0,100,0,0
2005,오태근,LG,7,2,1,1,50.0,0,0
2005,최동수,LG,77,1,1,0,100,0,0
2005,백승룡,한화,39,3,1,2,33.3,0,0
2005,심광호,한화,63,1,1,0,100,0,0
2005,임수민,한화,64,1,1,0,100,0,0
2005,최민준,한화,1,1,1,0,100,0,0
2005,한상훈,한화,94,1,1,0,100,0,0
2005,강민호,롯데,104,5,1,4,20.0,0,0
2005,박연수,롯데,71,4,1,3,25.0,0,0
2005,박현승,롯데,24,1,1,0,100,0,0
2005,이대호,롯데,126,1,1,0,100,0,0
2005,조인신,롯데,27,1,1,0,100,0,0
2005,김민범,현대,1,0,0,0,-,0,0
2005,김성태,현대,1,0,0,0,-,0,0
2005,김승권,현대,8,0,0,0,-,0,0
2005,노병오,현대,2,0,0,0,-,0,0
2005,노환수,현대,1,0,0,0,-,0,0
2005,박준수,현대,1,0,0,0,-,0,0
2005,서튼,현대,119,2,0,2,0.0,0,0
2005,송신영,현대,1,0,0,0,-,0,0
2005,오윤,현대,9,0,0,0,-,0,0
2005,오재일,현대,1,0,0,0,-,0,0
2005,유덕형,현대,3,0,0,0,-,0,0
2005,이동학,현대,2,0,0,0,-,0,0
2005,이보근,현대,1,0,0,0,-,0,0
2005,이상현,현대,4,0,0,0,-,0,0
2005,장교성,현대,37,2,0,2,0.0,0,0
2005,전근표,현대,37,1,0,1,0.0,0,0
2005,정민태,현대,1,0,0,0,-,0,0
2005,조승현,현대,5,0,0,0,-,0,0
2005,조용준,현대,4,0,0,0,-,0,0
2005,조재호,현대,16,1,0,1,0.0,0,0
2005,지석훈,현대,61,0,0,0,-,0,0
2005,차화준,현대,4,0,0,0,-,0,0
2005,허준,현대,2,0,0,0,-,0,0
2005,황두성,현대,2,0,0,0,-,0,0
2005,강영식,삼성,2,0,0,0,-,0,0
2005,곽용섭,삼성,3,0,0,0,-,0,0
2005,권오준,삼성,4,0,0,0,-,0,0
2005,김대익,삼성,61,0,0,0,-,0,0
2005,김덕윤,삼성,1,0,0,0,-,0,0
2005,김영복,삼성,23,0,0,0,-,0,0
2005,김진웅,삼성,1,0,0,0,-,0,0
2005,박성훈,삼성,1,0,0,0,-,0,0
2005,배영수,삼성,1,0,0,0,-,0,0
2005,손승현,삼성,8,0,0,0,-,0,0
2005,손주인,삼성,14,0,0,0,-,0,0
2005,오승환,삼성,7,0,0,0,-,0,0
2005,이정식,삼성,59,0,0,0,-,0,0
2005,이태호,삼성,1,0,0,0,-,0,0
2005,임창용,삼성,1,0,0,0,-,0,0
2005,전병호,삼성,2,0,0,0,-,0,0
2005,조영훈,삼성,7,0,0,0,-,0,0
2005,허연철,삼성,10,0,0,0,-,0,0
2005,강인권,두산,18,0,0,0,-,0,0
2005,고영민,두산,16,0,0,0,-,0,0
2005,금민철,두산,1,0,0,0,-,0,0
2005,김명제,두산,1,0,0,0,-,0,0
2005,김성배,두산,5,0,0,0,-,0,0
2005,김승회,두산,1,0,0,0,-,0,0
2005,김주호,두산,5,0,0,0,-,0,0
2005,김혜겸,두산,1,0,0,0,-,0,0
2005,리오스,두산,1,0,0,0,-,0,0
2005,박정배,두산,1,0,0,0,-,0,0
2005,서동환,두산,1,0,0,0,-,0,0
2005,윤석민,두산,1,0,0,0,-,0,0
2005,이경민,두산,1,0,0,0,-,0,0
2005,이대현,두산,1,0,0,0,-,0,0
2005,이승준,두산,24,0,0,0,-,0,0
2005,이원희,두산,8,0,0,0,-,0,0
2005,이재영,두산,2,0,0,0,-,0,0
2005,이재우,두산,5,0,0,0,-,0,0
2005,이혜천,두산,1,0,0,0,-,0,0
2005,정재훈,두산,8,0,0,0,-,0,0
2005,조현근,두산,4,0,0,0,-,0,0
2005,홍원기,두산,92,0,0,0,-,0,0
2005,황윤성,두산,55,0,0,0,-,0,0
2005,김경진,KIA,42,0,0,0,-,0,0
2005,김상훈,KIA,105,2,0,2,0.0,0,0
2005,김성호,KIA,2,0,0,0,-,0,0
2005,김원섭,KIA,28,0,0,0,-,0,0
2005,김주형,KIA,39,0,0,0,-,0,0
2005,마해영,KIA,94,0,0,0,-,0,0
2005,백정훈,KIA,1,0,0,0,-,0,0
2005,서동욱,KIA,12,0,0,0,-,0,0
2005,신동주,KIA,23,0,0,0,-,0,0
2005,신용운,KIA,3,0,0,0,-,0,0
2005,윤석민,KIA,2,0,0,0,-,0,0
2005,윤형진,KIA,1,0,0,0,-,0,0
2005,이범석,KIA,1,0,0,0,-,0,0
2005,이영수,KIA,4,0,0,0,-,0,0
2005,이재주,KIA,79,1,0,1,0.0,0,0
2005,임성민,KIA,47,0,0,0,-,0,0
2005,장일현,KIA,11,0,0,0,-,0,0
2005,전병두,KIA,2,0,0,0,-,0,0
2005,주창훈,KIA,1,0,0,0,-,0,0
2005,차일목,KIA,6,0,0,0,-,0,0
2005,홍현우,KIA,25,0,0,0,-,0,0
2005,강성우,SK,22,0,0,0,-,0,0
2005,김경태,SK,1,0,0,0,-,0,0
2005,김기태,SK,54,0,0,0,-,0,0
2005,김원형,SK,3,0,0,0,-,0,0
2005,김형철,SK,20,0,0,0,-,0,0
2005,위재영,SK,1,0,0,0,-,0,0
2005,윤길현,SK,1,0,0,0,-,0,0
2005,이영욱,SK,3,0,0,0,-,0,0
2005,정우람,SK,1,0,0,0,-,0,0
2005,조경환,SK,19,0,0,0,-,0,0
2005,조웅천,SK,4,0,0,0,-,0,0
2005,조형식,SK,1,0,0,0,-,0,0
2005,차바치,SK,1,0,0,0,-,0,0
2005,채종범,SK,8,0,0,0,-,0,0
2005,최경철,SK,43,0,0,0,-,0,0
2005,최정,SK,45,0,0,0,-,0,0
2005,최혁길,SK,1,0,0,0,-,0,0
2005,카브레라,SK,1,0,0,0,-,0,0
2005,경헌호,LG,2,0,0,0,-,0,0
2005,김민기,LG,1,0,0,0,-,0,0
2005,김우석,LG,30,0,0,0,-,0,0
2005,김정민,LG,79,2,0,2,0.0,0,0
2005,김태완,LG,29,1,0,1,0.0,0,0
2005,류택현,LG,1,0,0,0,-,0,0
2005,박기남,LG,56,1,0,1,0.0,0,0
2005,서용빈,LG,15,0,0,0,-,0,0
2005,송현우,LG,1,0,0,0,-,0,0
2005,신윤호,LG,2,0,0,0,-,0,0
2005,신재웅,LG,1,0,0,0,-,0,0
2005,심수창,LG,1,0,0,0,-,0,0
2005,안치용,LG,13,0,0,0,-,0,0
2005,왈론드,LG,1,0,0,0,-,0,0
2005,장문석,LG,1,0,0,0,-,0,0
2005,정재복,LG,2,0,0,0,-,0,0
2005,조인성,LG,85,0,0,0,-,0,0
2005,최길성,LG,4,0,0,0,-,0,0
2005,최승환,LG,16,0,0,0,-,0,0
2005,한규식,LG,115,1,0,1,0.0,0,0
2005,고지행,한화,25,0,0,0,-,0,0
2005,권영근,한화,7,0,0,0,-,0,0
2005,박노민,한화,9,0,0,0,-,0,0
2005,브리또,한화,78,1,0,1,0.0,0,0
2005,스미스,한화,30,0,0,0,-,0,0
2005,이도형,한화,113,0,0,0,-,0,0
2005,이양기,한화,10,0,0,0,-,0,0
2005,장종훈,한화,7,0,0,0,-,0,0
2005,전현태,한화,21,1,0,1,0.0,0,0
2005,정희상,한화,4,0,0,0,-,0,0
2005,조현수,한화,1,0,0,0,-,0,0
2005,최진행,한화,1,0,0,0,-,0,0
2005,가득염,롯데,2,0,0,0,-,0,0
2005,강상수,롯데,2,0,0,0,-,0,0
2005,권민성,롯데,10,0,0,0,-,0,0
2005,김승관,롯데,14,0,0,0,-,0,0
2005,노장진,롯데,2,0,0,0,-,0,0
2005,박경진,롯데,12,0,0,0,-,0,0
2005,박종윤,롯데,6,0,0,0,-,0,0
2005,손민한,롯데,1,0,0,0,-,0,0
2005,이계성,롯데,13,0,0,0,-,0,0
2005,이동훈,롯데,2,0,0,0,-,0,0
2005,이명우,롯데,4,0,0,0,-,0,0
2005,이왕기,롯데,5,0,0,0,-,0,0
2005,이용훈,롯데,1,0,0,0,-,0,0
2005,이원석,롯데,72,0,0,0,-,0,0
2005,이정민,롯데,2,0,0,0,-,0,0
2005,이정훈,롯데,4,0,0,0,-,0,0
2005,장원준,롯데,1,0,0,0,-,0,0
2005,조정훈,롯데,1,0,0,0,-,0,0
2005,조효상,롯데,38,0,0,0,-,0,0
2005,최대성,롯데,1,0,0,0,-,0,0
2005,황준영,롯데,17,0,0,0,-,0,0
2006,이종욱,두산,120,58,51,7,87.9,0,0
2006,정근우,SK,120,55,45,10,81.8,0,0
2006,이용규,KIA,125,49,38,11,77.6,0,0
2006,박용택,LG,126,28,25,3,89.3,0,0
2006,박재홍,SK,124,30,22,8,73.3,0,0
2006,강명구,삼성,91,27,21,6,77.8,0,0
2006,조동찬,삼성,107,24,20,4,83.3,0,0
2006,전준호,현대,109,27,20,7,74.1,0,0
2006,정수근,롯데,83,23,19,4,82.6,0,0
2006,민병헌,두산,80,20,17,3,85.0,0,0
2006,전상렬,두산,98,17,16,1,94.1,0,0
2006,고동진,한화,120,20,16,4,80.0,0,0
2006,김종국,KIA,111,21,16,5,76.2,0,0
2006,박한이,삼성,126,25,15,10,60.0,0,0
2006,이대형,LG,87,23,15,8,65.2,0,0
2006,고영민,두산,116,24,14,10,58.3,0,0
2006,양준혁,삼성,126,19,12,7,63.2,0,0
2006,오태근,LG,70,18,12,6,66.7,0,0
2006,김원섭,KIA,94,14,12,2,85.7,0,0
2006,김민재,한화,121,14,11,3,78.6,0,0
2006,박진만,삼성,115,16,10,6,62.5,0,0
2006,이종범,KIA,93,17,10,7,58.8,0,0
2006,김재걸,삼성,115,12,9,3,75.0,0,0
2006,조영훈,삼성,88,11,9,2,81.8,0,0
2006,임재철,두산,99,15,9,6,60.0,0,0
2006,강동우,두산,118,14,8,6,57.1,0,0
2006,김강민,SK,96,13,8,5,61.5,0,0
2006,조동화,SK,65,9,8,1,88.9,0,0
2006,박기혁,롯데,117,16,8,8,50.0,0,0
2006,서한규,현대,88,9,8,1,88.9,0,0
2006,송지만,현대,119,11,8,3,72.7,0,0
2006,이택근,현대,118,14,8,6,57.1,0,0
2006,데이비스,한화,117,13,7,6,53.8,0,0
2006,이승화,롯데,89,11,7,4,63.6,0,0
2006,정수성,현대,71,13,7,6,53.8,0,0
2006,김창희,삼성,114,8,6,2,75.0,0,0
2006,김한수,삼성,103,9,6,3,66.7,0,0
2006,박재상,SK,65,11,6,5,54.5,0,0
2006,조원우,한화,106,8,6,2,75.0,0,0
2006,클리어,한화,93,10,6,4,60.0,0,0
2006,권용관,LG,79,9,6,3,66.7,0,0
2006,장성호,KIA,126,9,6,3,66.7,0,0
2006,김재현,SK,109,7,5,2,71.4,0,0
2006,이대수,SK,122,6,5,1,83.3,0,0
2006,김수연,한화,109,7,5,2,71.4,0,0
2006,박현승,롯데,104,8,5,3,62.5,0,0
2006,신명철,롯데,73,6,5,1,83.3,0,0
2006,박경수,LG,107,7,5,2,71.4,0,0
2006,유한준,현대,110,8,5,3,62.5,0,0
2006,강봉규,삼성,87,7,4,3,57.1,0,0
2006,신경현,한화,100,5,4,1,80.0,0,0
2006,강민호,롯데,126,5,4,1,80.0,0,0
2006,안재만,LG,81,5,4,1,80.0,0,0
2006,최길성,LG,83,4,4,0,100.0,0,0
2006,차화준,현대,100,5,4,1,80.0,0,0
2006,박종호,삼성,104,4,3,1,75.0,0,0
2006,이정식,삼성,69,3,3,0,100.0,0,0
2006,안경현,두산,125,4,3,1,75.0,0,0
2006,정원석,두산,67,7,3,4,42.9,0,0
2006,이진영,SK,118,7,3,4,42.9,0,0
2006,조중근,SK,54,3,3,0,100.0,0,0
2006,최정,SK,92,5,3,2,60.0,0,0
2006,김인철,한화,69,4,3,1,75.0,0,0
2006,이원석,롯데,123,4,3,1,75.0,0,0
2006,호세,롯데,122,5,3,2,60.0,0,0
2006,황성용,롯데,77,7,3,4,42.9,0,0
2006,이병규,LG,120,5,3,2,60.0,0,0
2006,김동수,현대,115,4,3,1,75.0,0,0
2006,이숭용,현대,119,9,3,6,33.3,0,0
2006,정성훈,현대,122,7,3,4,42.9,0,0
2006,나주환,두산,114,9,2,7,22.2,0,0
2006,손시헌,두산,126,5,2,3,40.0,0,0
2006,김형철,SK,60,2,2,0,100.0,0,0
2006,박경완,SK,111,4,2,2,50.0,0,0
2006,피커링,SK,60,2,2,0,100.0,0,0
2006,김태균,한화,124,2,2,0,100.0,0,0
2006,심광호,한화,80,2,2,0,100.0,0,0
2006,한상훈,한화,95,3,2,1,66.7,0,0
2006,손인호,롯데,80,4,2,2,50.0,0,0
2006,최경환,롯데,86,4,2,2,50.0,0,0
2006,이성열,LG,56,3,2,1,66.7,0,0
2006,최만호,LG,46,2,2,0,100.0,0,0
2006,김민철,KIA,75,3,2,1,66.7,0,0
2006,서브넥,KIA,40,3,2,1,66.7,0,0
2006,이현곤,KIA,77,7,2,5,28.6,0,0
2006,김대익,삼성,107,2,1,1,50.0,0,0
2006,박정환,삼성,43,1,1,0,100.0,0,0
2006,진갑용,삼성,110,3,1,2,33.3,0,0
2006,김진수,두산,17,1,1,0,100.0,0,0
2006,문희성,두산,34,4,1,3,25.0,0,0
2006,윤승균,두산,4,2,1,1,50.0,0,0
2006,장원진,두산,98,3,1,2,33.3,0,0
2006,최준석,두산,109,2,1,1,50.0,0,0
2006,홍성흔,두산,119,2,1,1,50.0,0,0
2006,김재구,SK,45,1,1,0,100,0,0
2006,김태균,SK,116,3,1,2,33.3,0,0
2006,시오타니,SK,23,1,1,0,100,0,0
2006,백승룡,한화,37,1,1,0,100,0,0
2006,박남섭,롯데,67,2,1,1,50.0,0,0
2006,박정준,롯데,34,3,1,2,33.3,0,0
2006,마해영,LG,80,2,1,1,50.0,0,0
2006,박가람,LG,6,1,1,0,100,0,0
2006,박병호,LG,48,4,1,3,25.0,0,0
2006,이학준,LG,14,1,1,0,100,0,0
2006,정의윤,LG,82,1,1,0,100,0,0
2006,추승우,LG,38,1,1,0,100,0,0
2006,강병식,현대,93,2,1,1,50.0,0,0
2006,채종국,현대,97,3,1,2,33.3,0,0
2006,김경언,KIA,73,2,1,1,50.0,0,0
2006,김상훈,KIA,122,3,1,2,33.3,0,0
2006,손지환,KIA,96,2,1,1,50.0,0,0
2006,이재주,KIA,115,2,1,1,50.0,0,0
2006,조경환,KIA,54,1,1,0,100,0,0
2006,강영식,삼성,1,0,0,0,-,0,0
2006,김영복,삼성,7,0,0,0,-,0,0
2006,김종훈,삼성,96,2,0,2,0.0,0,0
2006,김효남,삼성,1,0,0,0,-,0,0
2006,심정수,삼성,26,0,0,0,-,0,0
2006,양영동,삼성,2,0,0,0,-,0,0
2006,오승환,삼성,1,0,0,0,-,0,0
2006,이태호,삼성,10,0,0,0,-,0,0
2006,임동규,삼성,1,0,0,0,-,0,0
2006,조현근,삼성,1,0,0,0,-,0,0
2006,채형직,삼성,1,0,0,0,-,0,0
2006,강인권,두산,6,0,0,0,-,0,0
2006,금민철,두산,2,0,0,0,-,0,0
2006,김덕윤,두산,1,0,0,0,-,0,0
2006,김동주,두산,43,0,0,0,-,0,0
2006,김명제,두산,5,0,0,0,-,0,0
2006,김상현,두산,2,0,0,0,-,0,0
2006,김성배,두산,3,0,0,0,-,0,0
2006,김승회,두산,8,0,0,0,-,0,0
2006,김주호,두산,13,0,0,0,-,0,0
2006,김현수,두산,1,0,0,0,-,0,0
2006,랜들,두산,1,0,0,0,-,0,0
2006,리오스,두산,1,0,0,0,-,0,0
2006,박명환,두산,1,0,0,0,-,0,0
2006,박정배,두산,3,0,0,0,-,0,0
2006,서동환,두산,2,0,0,0,-,0,0
2006,송수,두산,9,0,0,0,-,0,0
2006,용덕한,두산,58,0,0,0,-,0,0
2006,원용묵,두산,1,0,0,0,-,0,0
2006,윤석민,두산,27,0,0,0,-,0,0
2006,이대현,두산,1,0,0,0,-,0,0
2006,이승엽,두산,12,0,0,0,-,0,0
2006,이원희,두산,2,0,0,0,-,0,0
2006,이혜천,두산,2,0,0,0,-,0,0
2006,이호성,두산,1,0,0,0,-,0,0
2006,장교성,두산,5,0,0,0,-,0,0
2006,정재훈,두산,11,0,0,0,-,0,0
2006,최주환,두산,4,0,0,0,-,0,0
2006,고효준,SK,1,0,0,0,-,0,0
2006,김동건,SK,21,0,0,0,-,0,0
2006,김성현,SK,5,0,0,0,-,0,0
2006,송은범,SK,2,0,0,0,-,0,0
2006,양승학,SK,1,0,0,0,-,0,0
2006,윤길현,SK,1,0,0,0,-,0,0
2006,이영욱,SK,2,0,0,0,-,0,0
2006,이재원,SK,23,0,0,0,-,0,0
2006,장찬,SK,1,0,0,0,-,0,0
2006,정경배,SK,84,5,0,5,0.0,0,0
2006,정대현,SK,2,0,0,0,-,0,0
2006,정병희,SK,1,0,0,0,-,0,0
2006,정우람,SK,1,0,0,0,-,0,0
2006,조웅천,SK,2,0,0,0,-,0,0
2006,최경철,SK,63,0,0,0,-,0,0
2006,카브레라,SK,2,0,0,0,-,0,0
2006,홍명찬,SK,2,0,0,0,-,0,0
2006,구대성,한화,2,0,0,0,-,0,0
2006,김태완,한화,4,0,0,0,-,0,0
2006,김해님,한화,2,0,0,0,-,0,0
2006,류현진,한화,3,0,0,0,-,0,0
2006,문동환,한화,1,0,0,0,-,0,0
2006,백재호,한화,42,0,0,0,-,0,0
2006,송광민,한화,18,0,0,0,-,0,0
2006,연경흠,한화,96,0,0,0,-,0,0
2006,오승택,한화,3,0,0,0,-,0,0
2006,이도형,한화,119,2,0,2,0.0,0,0
2006,이범호,한화,126,2,0,2,0.0,0,0
2006,임수민,한화,13,0,0,0,-,0,0
2006,정범모,한화,4,0,0,0,-,0,0
2006,차명주,한화,1,0,0,0,-,0,0
2006,가득염,롯데,1,0,0,0,-,0,0
2006,김문호,롯데,8,0,0,0,-,0,0
2006,김수화,롯데,1,0,0,0,-,0,0
2006,김승관,롯데,50,0,0,0,-,0,0
2006,나승현,롯데,2,0,0,0,-,0,0
2006,노승욱,롯데,1,0,0,0,-,0,0
2006,마이로우,롯데,70,2,0,2,0.0,0,0
2006,박연수,롯데,42,0,0,0,-,0,0
2006,박지철,롯데,1,0,0,0,-,0,0
2006,박진환,롯데,1,0,0,0,-,0,0
2006,손용석,롯데,4,0,0,0,-,0,0
2006,이대호,롯데,122,1,0,1,0.0,0,0
2006,이동훈,롯데,7,0,0,0,-,0,0
2006,이명우,롯데,1,0,0,0,-,0,0
2006,이승재,롯데,38,0,0,0,-,0,0
2006,이승준,롯데,19,0,0,0,-,0,0
2006,이왕기,롯데,3,0,0,0,-,0,0
2006,이정민,롯데,1,0,0,0,-,0,0
2006,이정훈,롯데,1,0,0,0,-,0,0
2006,정보명,롯데,66,2,0,2,0.0,0,0
2006,존갈,롯데,43,2,0,2,0.0,0,0
2006,주형광,롯데,1,0,0,0,-,0,0
2006,최대성,롯데,2,0,0,0,-,0,0
2006,추경식,롯데,13,0,0,0,-,0,0
2006,황준영,롯데,2,0,0,0,-,0,0
2006,강상수,LG,1,0,0,0,-,0,0
2006,경헌호,LG,1,0,0,0,-,0,0
2006,김우석,LG,31,0,0,0,-,0,0
2006,김재현,LG,1,0,0,0,-,0,0
2006,김정민,LG,26,0,0,0,-,0,0
2006,박기남,LG,74,0,0,0,-,0,0
2006,서용빈,LG,32,2,0,2,0.0,0,0
2006,신윤호,LG,1,0,0,0,-,0,0
2006,안상준,LG,3,0,0,0,-,0,0
2006,안치용,LG,20,0,0,0,-,0,0
2006,우규민,LG,2,0,0,0,-,0,0
2006,이병규,LG,7,0,0,0,-,0,0
2006,이종열,LG,96,0,0,0,-,0,0
2006,정재복,LG,1,0,0,0,-,0,0
2006,조인성,LG,112,1,0,1,0.0,0,0
2006,최동수,LG,54,0,0,0,-,0,0
2006,최승준,LG,2,0,0,0,-,0,0
2006,최승환,LG,31,0,0,0,-,0,0
2006,황선일,LG,1,0,0,0,-,0,0
2006,강귀태,현대,73,2,0,2,0.0,0,0
2006,강정호,현대,10,1,0,1,0.0,0,0
2006,김민범,현대,2,0,0,0,-,0,0
2006,김성태,현대,1,0,0,0,-,0,0
2006,김승권,현대,21,0,0,0,-,0,0
2006,노환수,현대,1,0,0,0,-,0,0
2006,박준수,현대,2,0,0,0,-,0,0
2006,서튼,현대,93,0,0,0,-,0,0
2006,송신영,현대,2,0,0,0,-,0,0
2006,신철인,현대,1,0,0,0,-,0,0
2006,이보근,현대,3,0,0,0,-,0,0
2006,이현승,현대,1,0,0,0,-,0,0
2006,장태종,현대,2,0,0,0,-,0,0
2006,전근표,현대,51,0,0,0,-,0,0
2006,조평호,현대,9,0,0,0,-,0,0
2006,지석훈,현대,51,1,0,1,0.0,0,0
2006,허준,현대,1,0,0,0,-,0,0
2006,홍원기,현대,56,2,0,2,0.0,0,0
2006,황두성,현대,1,0,0,0,-,0,0
2006,김경진,KIA,14,0,0,0,-,0,0
2006,김주형,KIA,34,0,0,0,-,0,0
2006,송산,KIA,43,0,0,0,-,0,0
2006,스캇,KIA,48,0,0,0,-,0,0
2006,신동주,KIA,8,0,0,0,-,0,0
2006,심재학,KIA,56,2,0,2,0.0,0,0
2006,유재원,KIA,1,1,0,1,0.0,0,0
2006,윤석민,KIA,4,0,0,0,-,0,0
2006,이동현,KIA,1,0,0,0,-,0,0
2006,임준혁,KIA,1,0,0,0,-,0,0
2006,장문석,KIA,2,0,0,0,-,0,0
2006,전병두,KIA,1,0,0,0,-,0,0
2006,정원,KIA,1,0,0,0,-,0,0
2006,조태수,KIA,1,0,0,0,-,0,0
2006,차일목,KIA,22,0,0,0,-,0,0
2006,차정민,KIA,2,0,0,0,-,0,0
2006,한규식,KIA,55,0,0,0,-,0,0
2006,홍세완,KIA,66,0,0,0,-,0,0
2007,이대형,LG,125,73,53,20,72.6,0,0
2007,이종욱,두산,123,61,47,14,77.0,0,0
2007,고영민,두산,126,46,36,10,78.3,0,0
2007,민병헌,두산,119,39,30,9,76.9,0,0
2007,조동화,SK,121,31,25,6,80.6,0,0
2007,정근우,SK,111,34,24,10,70.6,0,0
2007,김주찬,롯데,113,30,22,8,73.3,0,0
2007,박재상,SK,123,28,21,7,75.0,0,0
2007,양준혁,삼성,123,28,20,8,71.4,0,0
2007,박용택,LG,126,22,20,2,90.9,0,0
2007,신명철,삼성,126,28,19,9,67.9,0,0
2007,김강민,SK,124,29,19,10,65.5,0,0
2007,김재걸,삼성,116,24,17,7,70.8,0,0
2007,이용규,KIA,118,28,17,11,60.7,0,0
2007,강명구,삼성,68,16,13,3,81.3,0,0
2007,김종국,KIA,93,16,13,3,81.3,0,0
2007,전준호,현대,121,19,11,8,57.9,0,0
2007,김동주,두산,119,13,11,2,84.6,0,0
2007,이승화,롯데,75,19,11,8,57.9,0,0
2007,권용관,LG,121,15,11,4,73.3,0,0
2007,박한이,삼성,123,13,10,3,76.9,0,0
2007,고동진,한화,124,14,10,4,71.4,0,0
2007,송지만,현대,120,14,10,4,71.4,0,0
2007,박재홍,SK,115,17,10,7,58.8,0,0
2007,정수근,롯데,105,15,10,5,66.7,0,0
2007,박경수,LG,115,13,10,3,76.9,0,0
2007,김일경,현대,117,12,9,3,75.0,0,0
2007,김원섭,KIA,114,18,9,9,50.0,0,0
2007,장성호,KIA,116,13,9,4,69.2,0,0
2007,전상렬,두산,75,14,9,5,64.3,0,0
2007,최정,SK,122,15,8,7,53.3,0,0
2007,김민재,한화,118,10,7,3,70.0,0,0
2007,이성열,LG,75,8,7,1,87.5,0,0
2007,심정수,삼성,124,6,6,0,100.0,0,0
2007,조원우,한화,114,7,6,1,85.7,0,0
2007,한상훈,한화,118,11,6,5,54.5,0,0
2007,이택근,현대,116,7,6,1,85.7,0,0
2007,박경완,SK,119,9,6,3,66.7,0,0
2007,이진영,SK,80,6,6,0,100.0,0,0
2007,김상현,LG,121,6,6,0,100.0,0,0
2007,박진만,삼성,100,8,5,3,62.5,0,0
2007,김현수,두산,99,7,5,2,71.4,0,0
2007,윤재국,두산,74,9,5,4,55.6,0,0
2007,이대수,두산,109,8,5,3,62.5,0,0
2007,정원석,두산,78,6,5,1,83.3,0,0
2007,박기혁,롯데,108,9,5,4,55.6,0,0
2007,정보명,롯데,119,6,5,1,83.3,0,0
2007,오태근,LG,68,10,5,5,50.0,0,0
2007,이종열,LG,121,8,5,3,62.5,0,0
2007,강봉규,삼성,83,6,4,2,66.7,0,0
2007,신경현,한화,107,4,4,0,100.0,0,0
2007,이영우,한화,97,6,4,2,66.7,0,0
2007,이현곤,KIA,126,6,4,2,66.7,0,0
2007,김재현,SK,84,8,4,4,50.0,0,0
2007,박용근,LG,67,6,4,2,66.7,0,0
2007,발데스,LG,116,5,4,1,80.0,0,0
2007,조동찬,삼성,38,4,3,1,75.0,0,0
2007,심광호,한화,76,4,3,1,75.0,0,0
2007,브룸바,현대,126,5,3,2,60.0,0,0
2007,김상훈,KIA,109,3,3,0,100.0,0,0
2007,송산,KIA,76,6,3,3,50.0,0,0
2007,이종범,KIA,84,5,3,2,60.0,0,0
2007,최희섭,KIA,52,4,3,1,75.0,0,0
2007,오재원,두산,49,5,3,2,60.0,0,0
2007,나주환,SK,117,7,3,4,42.9,0,0
2007,이호준,SK,101,9,3,6,33.3,0,0
2007,정경배,SK,116,6,3,3,50.0,0,0
2007,김창희,삼성,100,6,2,4,33.3,0,0
2007,김태균,한화,118,3,2,1,66.7,0,0
2007,이범호,한화,126,2,2,0,100.0,0,0
2007,김동수,현대,111,6,2,4,33.3,0,0
2007,유한준,현대,112,2,2,0,100.0,0,0
2007,이숭용,현대,95,3,2,1,66.7,0,0
2007,황재균,현대,63,4,2,2,50.0,0,0
2007,김연훈,KIA,52,3,2,1,66.7,0,0
2007,채상병,두산,91,4,2,2,50.0,0,0
2007,박정권,SK,100,3,2,1,66.7,0,0
2007,이원석,롯데,121,7,2,5,28.6,0,0
2007,이인구,롯데,65,4,2,2,50.0,0,0
2007,최만호,롯데,41,3,2,1,66.7,0,0
2007,정의윤,LG,88,4,2,2,50.0,0,0
2007,박정환,삼성,46,1,1,0,100.0,0,0
2007,조영훈,삼성,66,1,1,0,100.0,0,0
2007,김동영,한화,16,2,1,1,50.0,0,0
2007,김수연,한화,31,2,1,1,50.0,0,0
2007,정희상,한화,41,1,1,0,100.0,0,0
2007,크루즈,한화,121,1,1,0,100.0,0,0
2007,서한규,현대,48,2,1,1,50.0,0,0
2007,정성훈,현대,122,3,1,2,33.3,0,0
2007,정수성,현대,23,3,1,2,33.3,0,0
2007,차화준,현대,47,3,1,2,33.3,0,0
2007,김주형,KIA,36,2,1,1,50.0,0,0
2007,손지환,KIA,102,2,1,1,50.0,0,0
2007,이강서,KIA,15,1,1,0,100,0,0
2007,한규식,KIA,26,1,1,0,100,0,0
2007,김진수,두산,45,2,1,1,50.0,0,0
2007,안경현,두산,109,1,1,0,100,0,0
2007,최준석,두산,121,1,1,0,100,0,0
2007,이재원,SK,66,1,1,0,100,0,0
2007,정상호,SK,66,1,1,0,100,0,0
2007,강민호,롯데,125,5,1,4,20.0,0,0
2007,박현승,롯데,91,4,1,3,25.0,0,0
2007,이대호,롯데,121,1,1,0,100,0,0
2007,최기문,롯데,58,1,1,0,100,0,0
2007,최길성,롯데,56,1,1,0,100,0,0
2007,페레즈,롯데,47,2,1,1,50.0,0,0
2007,홍유택,롯데,6,1,1,0,100,0,0
2007,손인호,LG,39,2,1,1,50.0,0,0
2007,안치용,LG,12,1,1,0,100,0,0
2007,조인성,LG,124,2,1,1,50.0,0,0
2007,최동수,LG,125,2,1,1,50.0,0,0
2007,권오준,삼성,1,0,0,0,-,0,0
2007,김대익,삼성,69,1,0,1,0.0,0,0
2007,김동명,삼성,1,0,0,0,-,0,0
2007,김종훈,삼성,63,1,0,1,0.0,0,0
2007,김한수,삼성,101,2,0,2,0.0,0,0
2007,박종호,삼성,17,0,0,0,-,0,0
2007,손승현,삼성,3,0,0,0,-,0,0
2007,오승환,삼성,5,0,0,0,-,0,0
2007,유용목,삼성,5,0,0,0,-,0,0
2007,이여상,삼성,4,0,0,0,-,0,0
2007,이정식,삼성,65,0,0,0,-,0,0
2007,이태호,삼성,45,1,0,1,0.0,0,0
2007,임창용,삼성,2,0,0,0,-,0,0
2007,정현욱,삼성,1,0,0,0,-,0,0
2007,조현근,삼성,1,0,0,0,-,0,0
2007,진갑용,삼성,122,1,0,1,0.0,0,0
2007,차우찬,삼성,2,0,0,0,-,0,0
2007,채태인,삼성,31,0,0,0,-,0,0
2007,현재윤,삼성,6,0,0,0,-,0,0
2007,구대성,한화,2,0,0,0,-,0,0
2007,김강,한화,1,0,0,0,-,0,0
2007,김인철,한화,77,1,0,1,0.0,0,0
2007,김태완,한화,61,0,0,0,-,0,0
2007,마정길,한화,1,0,0,0,-,0,0
2007,백승룡,한화,8,0,0,0,-,0,0
2007,백재호,한화,80,0,0,0,-,0,0
2007,서정,한화,1,0,0,0,-,0,0
2007,송광민,한화,30,1,0,1,0.0,0,0
2007,안영명,한화,2,0,0,0,-,0,0
2007,연경흠,한화,36,0,0,0,-,0,0
2007,이도형,한화,79,0,0,0,-,0,0
2007,전현태,한화,2,0,0,0,-,0,0
2007,정범모,한화,3,0,0,0,-,0,0
2007,강귀태,현대,55,0,0,0,-,0,0
2007,강병식,현대,91,1,0,1,0.0,0,0
2007,강정호,현대,20,0,0,0,-,0,0
2007,권도영,현대,7,0,0,0,-,0,0
2007,김남형,현대,5,0,0,0,-,0,0
2007,김성태,현대,1,0,0,0,-,0,0
2007,노병오,현대,3,0,0,0,-,0,0
2007,노환수,현대,1,0,0,0,-,0,0
2007,박준수,현대,2,0,0,0,-,0,0
2007,송신영,현대,5,0,0,0,-,0,0
2007,오윤,현대,30,0,0,0,-,0,0
2007,유덕형,현대,3,0,0,0,-,0,0
2007,유선정,현대,5,0,0,0,-,0,0
2007,이동학,현대,1,0,0,0,-,0,0
2007,이보근,현대,1,0,0,0,-,0,0
2007,이상열,현대,1,0,0,0,-,0,0
2007,이승주,현대,9,0,0,0,-,0,0
2007,이현승,현대,3,0,0,0,-,0,0
2007,전근표,현대,4,0,0,0,-,0,0
2007,조용훈,현대,2,0,0,0,-,0,0
2007,조중근,현대,22,0,0,0,-,0,0
2007,조평호,현대,8,0,0,0,-,0,0
2007,지석훈,현대,89,3,0,3,0.0,0,0
2007,허준,현대,35,0,0,0,-,0,0
2007,홍원기,현대,25,0,0,0,-,0,0
2007,황두성,현대,1,0,0,0,-,0,0
2007,권윤민,KIA,11,0,0,0,-,0,0
2007,김건한,KIA,1,0,0,0,-,0,0
2007,김경진,KIA,28,0,0,0,-,0,0
2007,김정수,KIA,3,0,0,0,-,0,0
2007,서튼,KIA,34,0,0,0,-,0,0
2007,심재학,KIA,25,0,0,0,-,0,0
2007,양현종,KIA,3,0,0,0,-,0,0
2007,유재원,KIA,10,0,0,0,-,0,0
2007,이상화,KIA,1,0,0,0,-,0,0
2007,이재주,KIA,90,2,0,2,0.0,0,0
2007,이호신,KIA,21,0,0,0,-,0,0
2007,조경환,KIA,64,2,0,2,0.0,0,0
2007,차일목,KIA,41,0,0,0,-,0,0
2007,차정민,KIA,1,0,0,0,-,0,0
2007,최훈락,KIA,22,0,0,0,-,0,0
2007,한기주,KIA,2,0,0,0,-,0,0
2007,홍세완,KIA,59,2,0,2,0.0,0,0
2007,강동우,두산,25,1,0,1,0.0,0,0
2007,금민철,두산,5,0,0,0,-,0,0
2007,김덕윤,두산,2,0,0,0,-,0,0
2007,김명제,두산,3,0,0,0,-,0,0
2007,김상현,두산,2,0,0,0,-,0,0
2007,김승회,두산,1,0,0,0,-,0,0
2007,김하람,두산,1,0,0,0,-,0,0
2007,김혜겸,두산,8,0,0,0,-,0,0
2007,노경은,두산,2,0,0,0,-,0,0
2007,안상준,두산,46,0,0,0,-,0,0
2007,양의지,두산,3,0,0,0,-,0,0
2007,원용묵,두산,1,0,0,0,-,0,0
2007,유재웅,두산,20,0,0,0,-,0,0
2007,윤석민,두산,30,0,0,0,-,0,0
2007,이경필,두산,3,0,0,0,-,0,0
2007,이두환,두산,1,0,0,0,-,0,0
2007,이승학,두산,5,0,0,0,-,0,0
2007,임태훈,두산,9,0,0,0,-,0,0
2007,장원진,두산,23,0,0,0,-,0,0
2007,정재훈,두산,7,0,0,0,-,0,0
2007,정재훈,두산,11,0,0,0,-,0,0
2007,최주환,두산,3,0,0,0,-,0,0
2007,허도환,두산,1,0,0,0,-,0,0
2007,홍성흔,두산,80,2,0,2,0.0,0,0
2007,가득염,SK,4,0,0,0,-,0,0
2007,강혁,SK,10,0,0,0,-,0,0
2007,김경태,SK,1,0,0,0,-,0,0
2007,김광현,SK,1,0,0,0,-,0,0
2007,김동건,SK,10,0,0,0,-,0,0
2007,김성현,SK,3,1,0,1,0.0,0,0
2007,김용섭,SK,1,0,0,0,-,0,0
2007,김원형,SK,3,0,0,0,-,0,0
2007,김재구,SK,24,0,0,0,-,0,0
2007,김재현,SK,3,0,0,0,-,0,0
2007,김태균,SK,23,0,0,0,-,0,0
2007,김형철,SK,2,0,0,0,-,0,0
2007,레이번,SK,1,0,0,0,-,0,0
2007,로마노,SK,3,0,0,0,-,0,0
2007,박연수,SK,8,0,0,0,-,0,0
2007,송은범,SK,2,0,0,0,-,0,0
2007,윤길현,SK,1,0,0,0,-,0,0
2007,이영욱,SK,1,0,0,0,-,0,0
2007,이한진,SK,3,0,0,0,-,0,0
2007,정대현,SK,7,0,0,0,-,0,0
2007,정우람,SK,1,0,0,0,-,0,0
2007,조웅천,SK,6,0,0,0,-,0,0
2007,채종국,SK,23,0,0,0,-,0,0
2007,김문호,롯데,27,1,0,1,0.0,0,0
2007,김민성,롯데,4,0,0,0,-,0,0
2007,김승관,롯데,5,0,0,0,-,0,0
2007,나승현,롯데,1,0,0,0,-,0,0
2007,리오스,롯데,38,1,0,1,0.0,0,0
2007,문규현,롯데,25,0,0,0,-,0,0
2007,박남섭,롯데,75,0,0,0,-,0,0
2007,박종윤,롯데,8,0,0,0,-,0,0
2007,박지철,롯데,3,0,0,0,-,0,0
2007,서정호,롯데,3,0,0,0,-,0,0
2007,손광민,롯데,4,0,0,0,-,0,0
2007,손용석,롯데,44,1,0,1,0.0,0,0
2007,이동훈,롯데,3,0,0,0,-,0,0
2007,이승재,롯데,3,0,0,0,-,0,0
2007,이창석,롯데,3,0,0,0,-,0,0
2007,최경환,롯데,36,0,0,0,-,0,0
2007,카브레라,롯데,2,0,0,0,-,0,0
2007,허준혁,롯데,1,0,0,0,-,0,0
2007,호세,롯데,23,0,0,0,-,0,0
2007,황성용,롯데,69,1,0,1,0.0,0,0
2007,경헌호,LG,1,0,0,0,-,0,0
2007,김민기,LG,1,0,0,0,-,0,0
2007,김용우,LG,41,0,0,0,-,0,0
2007,김우석,LG,2,0,0,0,-,0,0
2007,김재현,LG,1,0,0,0,-,0,0
2007,김회권,LG,1,0,0,0,-,0,0
2007,류택현,LG,1,0,0,0,-,0,0
2007,마해영,LG,11,0,0,0,-,0,0
2007,민경수,LG,1,0,0,0,-,0,0
2007,박영복,LG,1,0,0,0,-,0,0
2007,송현우,LG,1,0,0,0,-,0,0
2007,신윤호,LG,1,0,0,0,-,0,0
2007,심수창,LG,6,0,0,0,-,0,0
2007,안재만,LG,10,0,0,0,-,0,0
2007,양현석,LG,3,0,0,0,-,0,0
2007,우규민,LG,5,0,0,0,-,0,0
2007,정재복,LG,2,0,0,0,-,0,0
2007,최승준,LG,4,0,0,0,-,0,0
2007,최승환,LG,22,0,0,0,-,0,0
2007,추승우,LG,1,0,0,0,-,0,0
2007,황선일,LG,44,0,0,0,-,0,0
2008,이대형,LG,126,78,63,15,80.8,0,0
2008,이종욱,두산,122,55,47,8,85.5,0,0
2008,정근우,SK,124,60,40,20,66.7,0,0
2008,고영민,두산,126,48,39,9,81.3,0,0
2008,김주찬,롯데,104,50,32,18,64.0,0,0
2008,조성환,롯데,123,34,31,3,91.2,0,0
2008,오재원,두산,117,35,28,7,80.0,0,0
2008,이용규,KIA,106,37,28,9,75.7,0,0
2008,클락,한화,125,30,25,5,83.3,0,0
2008,정수근,롯데,80,37,24,13,64.9,0,0
2008,박재상,SK,94,30,21,9,70.0,0,0
2008,김원섭,KIA,106,29,21,8,72.4,0,0
2008,조동화,SK,103,22,19,3,86.4,0,0
2008,최정,SK,114,27,19,8,70.4,0,0
2008,추승우,한화,119,24,19,5,79.2,0,0
2008,민병헌,두산,87,24,18,6,75.0,0,0
2008,이택근,우리,110,24,18,6,75.0,0,0
2008,김강민,SK,106,24,16,8,66.7,0,0
2008,박용택,LG,96,22,16,6,72.7,0,0
2008,박기혁,롯데,113,23,16,7,69.6,0,0
2008,전준호,우리,114,27,16,11,59.3,0,0
2008,정수성,우리,76,22,16,6,72.7,0,0
2008,장성호,KIA,85,20,15,5,75.0,0,0
2008,나주환,SK,118,19,14,5,73.7,0,0
2008,김현수,두산,126,21,13,8,61.9,0,0
2008,김민재,한화,114,16,13,3,81.3,0,0
2008,김종국,KIA,113,16,13,3,81.3,0,0
2008,발데스,KIA,47,17,13,4,76.5,0,0
2008,이진영,SK,95,18,12,6,66.7,0,0
2008,김재호,두산,112,15,12,3,80.0,0,0
2008,이범호,한화,125,13,12,1,92.3,0,0
2008,이인구,롯데,42,13,11,2,84.6,0,0
2008,모창민,SK,91,17,10,7,58.8,0,0
2008,황재균,우리,117,17,10,7,58.8,0,0
2008,신명철,삼성,97,10,9,1,90.0,0,0
2008,박용근,LG,93,13,9,4,69.2,0,0
2008,이종범,KIA,110,12,9,3,75.0,0,0
2008,이성열,두산,84,12,8,4,66.7,0,0
2008,홍성흔,두산,114,9,8,1,88.9,0,0
2008,조동찬,삼성,68,11,8,3,72.7,0,0
2008,정성훈,우리,109,12,8,4,66.7,0,0
2008,정원석,두산,90,10,7,3,70.0,0,0
2008,이여상,한화,94,9,7,2,77.8,0,0
2008,허승민,삼성,85,9,7,2,77.8,0,0
2008,안치용,LG,101,9,7,2,77.8,0,0
2008,유재신,우리,54,9,7,2,77.8,0,0
2008,박경완,SK,101,10,6,4,60.0,0,0
2008,김재걸,삼성,99,9,6,3,66.7,0,0
2008,박경수,LG,116,11,6,5,54.5,0,0
2008,박재홍,SK,112,11,5,6,45.5,0,0
2008,한상훈,한화,122,5,5,0,100.0,0,0
2008,박진만,삼성,104,9,5,4,55.6,0,0
2008,박한이,삼성,104,11,5,6,45.5,0,0
2008,김선빈,KIA,112,14,5,9,35.7,0,0
2008,이현곤,KIA,112,10,5,5,50.0,0,0
2008,차일목,KIA,106,9,5,4,55.6,0,0
2008,김일경,우리,70,8,5,3,62.5,0,0
2008,김재현,SK,108,7,4,3,57.1,0,0
2008,신경현,한화,107,7,4,3,57.1,0,0
2008,이승화,롯데,87,7,4,3,57.1,0,0
2008,정보명,롯데,96,11,4,7,36.4,0,0
2008,최희섭,KIA,55,7,4,3,57.1,0,0
2008,송지만,우리,118,9,4,5,44.4,0,0
2008,전상렬,두산,59,6,3,3,50.0,0,0
2008,강봉규,삼성,81,7,3,4,42.9,0,0
2008,최형우,삼성,126,3,3,0,100.0,0,0
2008,박현승,롯데,73,7,3,4,42.9,0,0
2008,강정호,우리,116,4,3,1,75.0,0,0
2008,이재원,SK,82,2,2,0,100.0,0,0
2008,김동주,두산,109,4,2,2,50.0,0,0
2008,이대수,두산,90,6,2,4,33.3,0,0
2008,고동진,한화,31,2,2,0,100.0,0,0
2008,김태균,한화,115,2,2,0,100.0,0,0
2008,윤재국,한화,55,2,2,0,100.0,0,0
2008,이영우,한화,89,3,2,1,66.7,0,0
2008,이희근,한화,84,2,2,0,100.0,0,0
2008,김창희,삼성,103,3,2,1,66.7,0,0
2008,박석민,삼성,126,5,2,3,40.0,0,0
2008,우동균,삼성,63,5,2,3,40.0,0,0
2008,현재윤,삼성,67,2,2,0,100.0,0,0
2008,김상현,LG,75,5,2,3,40.0,0,0
2008,가르시아,롯데,125,3,2,1,66.7,0,0
2008,강민호,롯데,122,6,2,4,33.3,0,0
2008,손광민,롯데,80,5,2,3,40.0,0,0
2008,이원석,롯데,53,3,2,1,66.7,0,0
2008,유재원,KIA,13,2,2,0,100.0,0,0
2008,이재주,KIA,87,3,2,1,66.7,0,0
2008,이호신,KIA,10,3,2,1,66.7,0,0
2008,채종범,KIA,70,3,2,1,66.7,0,0
2008,최경환,KIA,65,2,2,0,100.0,0,0
2008,김남형,우리,21,3,2,1,66.7,0,0
2008,오윤,우리,31,2,2,0,100.0,0,0
2008,박정환,SK,25,2,1,1,50.0,0,0
2008,안경현,두산,51,2,1,1,50.0,0,0
2008,유재웅,두산,104,5,1,4,20.0,0,0
2008,최준석,두산,67,1,1,0,100.0,0,0
2008,김수연,한화,9,1,1,0,100.0,0,0
2008,오승택,한화,50,4,1,3,25.0,0,0
2008,김우석,삼성,8,1,1,0,100.0,0,0
2008,양준혁,삼성,114,2,1,1,50.0,0,0
2008,진갑용,삼성,105,2,1,1,50.0,0,0
2008,채태인,삼성,68,2,1,1,50.0,0,0
2008,크루즈,삼성,43,1,1,0,100.0,0,0
2008,권용관,LG,76,3,1,2,33.3,0,0
2008,김용의,LG,18,1,1,0,100.0,0,0
2008,김정민,LG,71,2,1,1,50.0,0,0
2008,손인호,LG,77,1,1,0,100.0,0,0
2008,오태근,LG,7,2,1,1,50.0,0,0
2008,채종국,LG,55,1,1,0,100.0,0,0
2008,페타지니,LG,68,1,1,0,100.0,0,0
2008,김상훈,KIA,35,2,1,1,50.0,0,0
2008,김형철,KIA,45,3,1,2,33.3,0,0
2008,나지완,KIA,73,3,1,2,33.3,0,0
2008,최용규,KIA,20,3,1,2,33.3,0,0
2008,강귀태,우리,104,2,1,1,50.0,0,0
2008,브룸바,우리,102,2,1,1,50.0,0,0
2008,이숭용,우리,109,3,1,2,33.3,0,0
2008,장기영,우리,9,2,1,1,50.0,0,0
2008,조재호,우리,49,3,1,2,33.3,0,0
2008,조중근,우리,31,1,1,0,100.0,0,0
2008,가득염,SK,3,0,0,0,-,0,0
2008,권영진,SK,31,0,0,0,-,0,0
2008,김동건,SK,14,0,0,0,-,0,0
2008,김성현,SK,6,0,0,0,-,0,0
2008,김연훈,SK,19,0,0,0,-,0,0
2008,김원형,SK,3,0,0,0,-,0,0
2008,김재구,SK,5,0,0,0,-,0,0
2008,김재현,SK,2,0,0,0,-,0,0
2008,박연수,SK,5,0,0,0,-,0,0
2008,박정권,SK,56,0,0,0,-,0,0
2008,얀,SK,2,0,0,0,-,0,0
2008,오현근,SK,5,1,0,1,0.0,0,0
2008,윤길현,SK,2,0,0,0,-,0,0
2008,윤상균,SK,7,0,0,0,-,0,0
2008,이명기,SK,6,1,0,1,0.0,0,0
2008,이호준,SK,8,0,0,0,-,0,0
2008,정경배,SK,33,0,0,0,-,0,0
2008,정대현,SK,6,0,0,0,-,0,0
2008,정상호,SK,81,1,0,1,0.0,0,0
2008,정우람,SK,1,0,0,0,-,0,0
2008,조영민,SK,4,0,0,0,-,0,0
2008,조웅천,SK,5,0,0,0,-,0,0
2008,최상덕,SK,1,0,0,0,-,0,0
2008,금민철,두산,1,0,0,0,-,0,0
2008,김강률,두산,1,0,0,0,-,0,0
2008,김덕윤,두산,1,0,0,0,-,0,0
2008,김상현,두산,2,0,0,0,-,0,0
2008,김재환,두산,14,1,0,1,0.0,0,0
2008,김진수,두산,5,0,0,0,-,0,0
2008,레이어,두산,2,0,0,0,-,0,0
2008,박민석,두산,2,0,0,0,-,0,0
2008,이경환,두산,1,0,0,0,-,0,0
2008,이용찬,두산,1,0,0,0,-,0,0
2008,이원재,두산,1,0,0,0,-,0,0
2008,이재우,두산,4,0,0,0,-,0,0
2008,이혜천,두산,1,0,0,0,-,0,0
2008,임태훈,두산,6,0,0,0,-,0,0
2008,정재훈,두산,9,0,0,0,-,0,0
2008,진야곱,두산,2,0,0,0,-,0,0
2008,채상병,두산,112,0,0,0,-,0,0
2008,최승환,두산,63,0,0,0,-,0,0
2008,최재훈,두산,1,0,0,0,-,0,0
2008,최주환,두산,16,0,0,0,-,0,0
2008,김동영,한화,4,0,0,0,-,0,0
2008,김태완,한화,124,1,0,1,0.0,0,0
2008,김혁민,한화,3,0,0,0,-,0,0
2008,마정길,한화,1,0,0,0,-,0,0
2008,백승룡,한화,2,0,0,0,-,0,0
2008,송광민,한화,75,0,0,0,-,0,0
2008,양훈,한화,1,0,0,0,-,0,0
2008,연경흠,한화,45,0,0,0,-,0,0
2008,오선진,한화,46,0,0,0,-,0,0
2008,윤규진,한화,1,0,0,0,-,0,0
2008,이도형,한화,54,0,0,0,-,0,0
2008,정범모,한화,3,1,0,1,0.0,0,0
2008,정현석,한화,11,0,0,0,-,0,0
2008,조원우,한화,5,0,0,0,-,0,0
2008,최진행,한화,3,0,0,0,-,0,0
2008,토마스,한화,7,0,0,0,-,0,0
2008,한윤섭,한화,6,0,0,0,-,0,0
2008,김경모,삼성,2,0,0,0,-,0,0
2008,김동현,삼성,14,1,0,1,0.0,0,0
2008,모상기,삼성,2,0,0,0,-,0,0
2008,박종호,삼성,33,1,0,1,0.0,0,0
2008,백정현,삼성,1,0,0,0,-,0,0
2008,손승현,삼성,4,0,0,0,-,0,0
2008,손주인,삼성,9,0,0,0,-,0,0
2008,손지환,삼성,45,1,0,1,0.0,0,0
2008,심광호,삼성,40,0,0,0,-,0,0
2008,심정수,삼성,22,1,0,1,0.0,0,0
2008,오승환,삼성,1,0,0,0,-,0,0
2008,이영욱,삼성,14,0,0,0,-,0,0
2008,차우찬,삼성,1,0,0,0,-,0,0
2008,최원제,삼성,1,0,0,0,-,0,0
2008,경헌호,LG,1,0,0,0,-,0,0
2008,김광삼,LG,13,1,0,1,0.0,0,0
2008,김민기,LG,1,0,0,0,-,0,0
2008,김수형,LG,1,0,0,0,-,0,0
2008,김용우,LG,25,0,0,0,-,0,0
2008,김준호,LG,29,0,0,0,-,0,0
2008,김태군,LG,6,0,0,0,-,0,0
2008,김태완,LG,37,0,0,0,-,0,0
2008,김회권,LG,1,0,0,0,-,0,0
2008,서건창,LG,1,0,0,0,-,0,0
2008,서동욱,LG,27,0,0,0,-,0,0
2008,서성종,LG,1,0,0,0,-,0,0
2008,오상민,LG,2,0,0,0,-,0,0
2008,우규민,LG,2,0,0,0,-,0,0
2008,이범준,LG,3,0,0,0,-,0,0
2008,이병규,LG,33,0,0,0,-,0,0
2008,이재영,LG,1,0,0,0,-,0,0
2008,이종열,LG,81,1,0,1,0.0,0,0
2008,임도현,LG,15,0,0,0,-,0,0
2008,정의윤,LG,38,0,0,0,-,0,0
2008,정재복,LG,4,0,0,0,-,0,0
2008,조인성,LG,102,0,0,0,-,0,0
2008,최동수,LG,110,3,0,3,0.0,0,0
2008,강영식,롯데,2,0,0,0,-,0,0
2008,김문호,롯데,3,0,0,0,-,0,0
2008,김민성,롯데,20,0,0,0,-,0,0
2008,김이슬,롯데,1,0,0,0,-,0,0
2008,마해영,롯데,32,0,0,0,-,0,0
2008,박남섭,롯데,26,0,0,0,-,0,0
2008,박종윤,롯데,15,0,0,0,-,0,0
2008,서정호,롯데,4,0,0,0,-,0,0
2008,염종석,롯데,2,0,0,0,-,0,0
2008,이대호,롯데,122,1,0,1,0.0,0,0
2008,이동훈,롯데,5,0,0,0,-,0,0
2008,임경완,롯데,2,0,0,0,-,0,0
2008,전준우,롯데,15,0,0,0,-,0,0
2008,최기문,롯데,29,1,0,1,0.0,0,0
2008,최만호,롯데,28,0,0,0,-,0,0
2008,코르테스,롯데,1,0,0,0,-,0,0
2008,강동우,KIA,45,1,0,1,0.0,0,0
2008,고우석,KIA,1,0,0,0,-,0,0
2008,김경언,KIA,8,0,0,0,-,0,0
2008,김주현,KIA,2,0,0,0,-,0,0
2008,김주형,KIA,62,1,0,1,0.0,0,0
2008,디아즈,KIA,1,0,0,0,-,0,0
2008,박진영,KIA,10,0,0,0,-,0,0
2008,송산,KIA,14,0,0,0,-,0,0
2008,심재학,KIA,1,0,0,0,-,0,0
2008,안재만,KIA,3,0,0,0,-,0,0
2008,유용목,KIA,6,0,0,0,-,0,0
2008,이성우,KIA,39,0,0,0,-,0,0
2008,이영수,KIA,15,0,0,0,-,0,0
2008,진민호,KIA,2,0,0,0,-,0,0
2008,한기주,KIA,2,0,0,0,-,0,0
2008,강병식,우리,71,2,0,2,0.0,0,0
2008,권도영,우리,84,1,0,1,0.0,0,0
2008,김동수,우리,94,0,0,0,-,0,0
2008,김민우,우리,16,0,0,0,-,0,0
2008,김성현,우리,2,0,0,0,-,0,0
2008,김수경,우리,2,0,0,0,-,0,0
2008,김영민,우리,1,0,0,0,-,0,0
2008,노환수,우리,2,0,0,0,-,0,0
2008,다카쓰,우리,3,0,0,0,-,0,0
2008,민성기,우리,1,0,0,0,-,0,0
2008,박준수,우리,2,0,0,0,-,0,0
2008,배힘찬,우리,1,0,0,0,-,0,0
2008,송신영,우리,3,0,0,0,-,0,0
2008,스코비,우리,1,0,0,0,-,0,0
2008,유선정,우리,15,0,0,0,-,0,0
2008,이성재,우리,7,0,0,0,-,0,0
2008,이정호,우리,3,0,0,0,-,0,0
2008,이현승,우리,1,0,0,0,-,0,0
2008,전근표,우리,32,0,0,0,-,0,0
2008,전동수,우리,11,0,0,0,-,0,0
2008,전준호,우리,1,0,0,0,-,0,0
2008,정종수,우리,1,0,0,0,-,0,0
2008,조순권,우리,1,0,0,0,-,0,0
2008,조용훈,우리,5,0,0,0,-,0,0
2008,조평호,우리,14,0,0,0,-,0,0
2008,지석훈,우리,12,0,0,0,-,0,0
2008,차화준,우리,3,0,0,0,-,0,0
2008,최현종,우리,18,1,0,1,0.0,0,0
2008,허준,우리,15,0,0,0,-,0,0
2008,황두성,우리,3,0,0,0,-,0,0
2009,이대형,LG,133,82,64,18,78.0,0,0
2009,정근우,SK,127,66,53,13,80.3,0,0
2009,이택근,히어로즈,123,51,43,8,84.3,0,0
2009,이종욱,두산,82,43,37,6,86.0,0,0
2009,김주찬,롯데,109,41,34,7,82.9,0,0
2009,박재상,SK,133,44,33,11,75.0,0,0
2009,김일경,히어로즈,107,42,30,12,71.4,0,0
2009,황재균,히어로즈,133,45,30,15,66.7,0,0
2009,강동우,한화,128,30,27,3,90.0,0,0
2009,클락,히어로즈,125,31,23,8,74.2,0,0
2009,박용택,LG,111,25,22,3,88.0,0,0
2009,나주환,SK,118,30,21,9,70.0,0,0
2009,신명철,삼성,124,27,21,6,77.8,0,0
2009,조동찬,삼성,75,22,21,1,95.5,0,0
2009,정수성,히어로즈,87,27,21,6,77.8,0,0
2009,강봉규,삼성,126,23,20,3,87.0,0,0
2009,김원섭,KIA,101,30,20,10,66.7,0,0
2009,박용근,LG,101,25,19,6,76.0,0,0
2009,민병헌,두산,115,23,18,5,78.3,0,0
2009,김상수,삼성,97,24,18,6,75.0,0,0
2009,이영욱,삼성,88,20,16,4,80.0,0,0
2009,박재홍,SK,113,19,15,4,78.9,0,0
2009,추승우,한화,105,19,15,4,78.9,0,0
2009,정수빈,두산,85,20,13,7,65.0,0,0
2009,조성환,롯데,76,15,13,2,86.7,0,0
2009,고영민,두산,85,16,12,4,75.0,0,0
2009,오재원,두산,106,15,12,3,80.0,0,0
2009,이승화,롯데,102,15,12,3,80.0,0,0
2009,최정,SK,99,11,11,0,100.0,0,0
2009,임재철,두산,121,16,11,5,68.8,0,0
2009,이종범,KIA,123,12,11,1,91.7,0,0
2009,이현곤,KIA,120,14,11,3,78.6,0,0
2009,김강민,SK,104,17,10,7,58.8,0,0
2009,이용규,KIA,50,14,10,4,71.4,0,0
2009,송지만,히어로즈,115,13,10,3,76.9,0,0
2009,홍성흔,롯데,119,12,9,3,75.0,0,0
2009,김민우,히어로즈,78,9,9,0,100.0,0,0
2009,김재현,SK,112,9,8,1,88.9,0,0
2009,김선빈,KIA,72,10,8,2,80.0,0,0
2009,안치홍,KIA,123,13,8,5,61.5,0,0
2009,이숭용,히어로즈,114,11,8,3,72.7,0,0
2009,조동화,SK,102,10,7,3,70.0,0,0
2009,박기혁,롯데,109,13,7,6,53.8,0,0
2009,박한이,삼성,110,12,7,5,58.3,0,0
2009,김상현,KIA,121,12,7,5,58.3,0,0
2009,장성호,KIA,88,12,7,5,58.3,0,0
2009,최용규,KIA,51,12,7,5,58.3,0,0
2009,김현수,두산,133,12,6,6,50.0,0,0
2009,손시헌,두산,121,9,6,3,66.7,0,0
2009,이인구,롯데,95,12,6,6,50.0,0,0
2009,박경수,LG,106,10,6,4,60.0,0,0
2009,모창민,SK,92,12,5,7,41.7,0,0
2009,박정권,SK,131,9,5,4,55.6,0,0
2009,김민성,롯데,114,10,5,5,50.0,0,0
2009,우동균,삼성,76,7,5,2,71.4,0,0
2009,송광민,한화,116,5,5,0,100.0,0,0
2009,장기영,히어로즈,15,5,5,0,100.0,0,0
2009,권용관,LG,128,8,5,3,62.5,0,0
2009,이진영,LG,120,7,5,2,71.4,0,0
2009,정성훈,LG,121,5,5,0,100.0,0,0
2009,김연훈,SK,68,6,4,2,66.7,0,0
2009,김재호,두산,80,5,4,1,80.0,0,0
2009,가르시아,롯데,130,7,4,3,57.1,0,0
2009,김재걸,삼성,64,6,4,2,66.7,0,0
2009,현재윤,삼성,99,9,4,5,44.4,0,0
2009,이여상,한화,79,5,4,1,80.0,0,0
2009,나지완,KIA,128,5,4,1,80.0,0,0
2009,최경환,KIA,47,4,4,0,100.0,0,0
2009,박경완,SK,65,4,3,1,75.0,0,0
2009,윤상균,SK,28,3,3,0,100.0,0,0
2009,김동주,두산,105,4,3,1,75.0,0,0
2009,박정준,롯데,63,7,3,4,42.9,0,0
2009,장성우,롯데,44,3,3,0,100.0,0,0
2009,정수근,롯데,15,3,3,0,100.0,0,0
2009,양준혁,삼성,82,7,3,4,42.9,0,0
2009,오선진,한화,79,5,3,2,60.0,0,0
2009,이범호,한화,126,4,3,1,75.0,0,0
2009,강귀태,히어로즈,114,5,3,2,60.0,0,0
2009,강정호,히어로즈,133,5,3,2,60.0,0,0
2009,김태완,LG,40,3,3,0,100.0,0,0
2009,안치용,LG,90,5,3,2,60.0,0,0
2009,박정환,SK,45,3,2,1,66.7,0,0
2009,이성열,두산,31,2,2,0,100.0,0,0
2009,이원석,두산,125,8,2,6,25.0,0,0
2009,정보명,롯데,86,5,2,3,40.0,0,0
2009,박진만,삼성,76,3,2,1,66.7,0,0
2009,디아즈,한화,62,3,2,1,66.7,0,0
2009,연경흠,한화,122,3,2,1,66.7,0,0
2009,이영우,한화,93,3,2,1,66.7,0,0
2009,한윤섭,한화,22,3,2,1,66.7,0,0
2009,김상훈,KIA,124,3,2,1,66.7,0,0
2009,김종국,KIA,51,2,2,0,100.0,0,0
2009,박기남,KIA,104,2,2,0,100.0,0,0
2009,신종길,KIA,16,3,2,1,66.7,0,0
2009,이성우,KIA,13,2,2,0,100.0,0,0
2009,차일목,KIA,57,4,2,2,50.0,0,0
2009,최희섭,KIA,131,6,2,4,33.3,0,0
2009,홍세완,KIA,74,4,2,2,50.0,0,0
2009,강병식,히어로즈,54,4,2,2,50.0,0,0
2009,브룸바,히어로즈,123,4,2,2,50.0,0,0
2009,전준호,히어로즈,21,6,2,4,33.3,0,0
2009,박병호,LG,68,3,2,1,66.7,0,0
2009,페타지니,LG,115,2,2,0,100.0,0,0
2009,손지환,SK,6,1,1,0,100.0,0,0
2009,이대수,두산,38,2,1,1,50.0,0,0
2009,최승환,두산,84,1,1,0,100.0,0,0
2009,최준석,두산,116,1,1,0,100.0,0,0
2009,박남섭,롯데,40,1,1,0,100.0,0,0
2009,손아섭,롯데,34,2,1,1,50.0,0,0
2009,전준우,롯데,26,1,1,0,100.0,0,0
2009,최기문,롯데,54,1,1,0,100.0,0,0
2009,최만호,롯데,13,1,1,0,100.0,0,0
2009,김창희,삼성,71,3,1,2,33.3,0,0
2009,진갑용,삼성,57,3,1,2,33.3,0,0
2009,최형우,삼성,113,3,1,2,33.3,0,0
2009,허승민,삼성,21,3,1,2,33.3,0,0
2009,김민재,한화,105,2,1,1,50.0,0,0
2009,김태완,한화,112,2,1,1,50.0,0,0
2009,박노민,한화,46,1,1,0,100.0,0,0
2009,정현석,한화,24,1,1,0,100.0,0,0
2009,이호신,KIA,13,2,1,1,50.0,0,0
2009,권도영,히어로즈,38,1,1,0,100,0,0
2009,박영복,LG,13,2,1,1,50.0,0,0
2009,손인호,LG,61,4,1,3,25.0,0,0
2009,임도현,LG,15,2,1,1,50.0,0,0
2009,최동수,LG,108,1,1,0,100,0,0
2009,권영진,SK,2,0,0,0,-,0,0
2009,김광현,SK,1,0,0,0,-,0,0
2009,김기현,SK,1,0,0,0,-,0,0
2009,김동건,SK,4,0,0,0,-,0,0
2009,김용우,SK,4,0,0,0,-,0,0
2009,김원형,SK,1,0,0,0,-,0,0
2009,김정남,SK,15,0,0,0,-,0,0
2009,안경현,SK,42,0,0,0,-,0,0
2009,엄정욱,SK,1,0,0,0,-,0,0
2009,오현근,SK,4,0,0,0,-,0,0
2009,윤길현,SK,3,0,0,0,-,0,0
2009,윤재국,SK,26,0,0,0,-,0,0
2009,이명기,SK,4,1,0,1,0.0,0,0
2009,이승호,SK,1,0,0,0,-,0,0
2009,이승호,SK,1,0,0,0,-,0,0
2009,이재원,SK,24,0,0,0,-,0,0
2009,이호준,SK,103,0,0,0,-,0,0
2009,임성헌,SK,2,0,0,0,-,0,0
2009,정경배,SK,31,0,0,0,-,0,0
2009,정대현,SK,4,0,0,0,-,0,0
2009,정상호,SK,101,4,0,4,0.0,0,0
2009,정우람,SK,3,0,0,0,-,0,0
2009,채병용,SK,1,0,0,0,-,0,0
2009,카도쿠라,SK,1,0,0,0,-,0,0
2009,하지호,SK,2,0,0,0,-,0,0
2009,허일상,SK,2,0,0,0,-,0,0
2009,고창성,두산,4,0,0,0,-,0,0
2009,금민철,두산,2,0,0,0,-,0,0
2009,김명제,두산,2,0,0,0,-,0,0
2009,김상현,두산,1,0,0,0,-,0,0
2009,김성배,두산,1,0,0,0,-,0,0
2009,김진수,두산,30,0,0,0,-,0,0
2009,박건우,두산,5,0,0,0,-,0,0
2009,박정배,두산,1,0,0,0,-,0,0
2009,오현택,두산,2,0,0,0,-,0,0
2009,왓슨,두산,10,0,0,0,-,0,0
2009,용덕한,두산,79,2,0,2,0.0,0,0
2009,유재웅,두산,66,0,0,0,-,0,0
2009,이용찬,두산,8,0,0,0,-,0,0
2009,이재우,두산,2,0,0,0,-,0,0
2009,임태훈,두산,3,0,0,0,-,0,0
2009,조승수,두산,1,0,0,0,-,0,0
2009,지승민,두산,1,0,0,0,-,0,0
2009,진야곱,두산,1,0,0,0,-,0,0
2009,최주환,두산,9,0,0,0,-,0,0
2009,강민호,롯데,83,0,0,0,-,0,0
2009,강영식,롯데,1,0,0,0,-,0,0
2009,김일엽,롯데,1,0,0,0,-,0,0
2009,문규현,롯데,11,0,0,0,-,0,0
2009,박종윤,롯데,47,1,0,1,0.0,0,0
2009,배장호,롯데,1,0,0,0,-,0,0
2009,서정호,롯데,2,0,0,0,-,0,0
2009,애킨스,롯데,2,0,0,0,-,0,0
2009,양종민,롯데,6,0,0,0,-,0,0
2009,오장훈,롯데,3,1,0,1,0.0,0,0
2009,이대호,롯데,133,0,0,0,-,0,0
2009,이동훈,롯데,4,0,0,0,-,0,0
2009,이정동,롯데,1,0,0,0,-,0,0
2009,이정민,롯데,2,0,0,0,-,0,0
2009,이정훈,롯데,3,0,0,0,-,0,0
2009,임경완,롯데,2,0,0,0,-,0,0
2009,장원준,롯데,1,0,0,0,-,0,0
2009,하준호,롯데,1,0,0,0,-,0,0
2009,권혁,삼성,1,0,0,0,-,0,0
2009,김동현,삼성,2,0,0,0,-,0,0
2009,박민규,삼성,1,0,0,0,-,0,0
2009,박석민,삼성,97,0,0,0,-,0,0
2009,백정현,삼성,1,0,0,0,-,0,0
2009,손주인,삼성,80,3,0,3,0.0,0,0
2009,심광호,삼성,2,0,0,0,-,0,0
2009,안지만,삼성,1,0,0,0,-,0,0
2009,오승환,삼성,1,0,0,0,-,0,0
2009,오정복,삼성,6,0,0,0,-,0,0
2009,이지영,삼성,23,0,0,0,-,0,0
2009,정형식,삼성,1,0,0,0,-,0,0
2009,조현근,삼성,1,0,0,0,-,0,0
2009,차우찬,삼성,1,0,0,0,-,0,0
2009,채상병,삼성,49,0,0,0,-,0,0
2009,채태인,삼성,118,0,0,0,-,0,0
2009,최원제,삼성,1,0,0,0,-,0,0
2009,강병수,한화,16,0,0,0,-,0,0
2009,구대성,한화,2,0,0,0,-,0,0
2009,김강,한화,7,0,0,0,-,0,0
2009,김강석,한화,3,0,0,0,-,0,0
2009,김태균,한화,95,0,0,0,-,0,0
2009,김회성,한화,20,0,0,0,-,0,0
2009,신경현,한화,78,3,0,3,0.0,0,0
2009,양승학,한화,44,0,0,0,-,0,0
2009,양훈,한화,2,0,0,0,-,0,0
2009,윤규진,한화,1,0,0,0,-,0,0
2009,이도형,한화,98,0,0,0,-,0,0
2009,이양기,한화,15,0,0,0,-,0,0
2009,이희근,한화,42,0,0,0,-,0,0
2009,최연오,한화,5,0,0,0,-,0,0
2009,최영필,한화,1,0,0,0,-,0,0
2009,최진행,한화,28,0,0,0,-,0,0
2009,토마스,한화,2,0,0,0,-,0,0
2009,고우석,KIA,3,0,0,0,-,0,0
2009,곽정철,KIA,3,0,0,0,-,0,0
2009,김경언,KIA,2,0,0,0,-,0,0
2009,김영수,KIA,1,0,0,0,-,0,0
2009,김형철,KIA,6,0,0,0,-,0,0
2009,박경태,KIA,2,0,0,0,-,0,0
2009,박정규,KIA,1,0,0,0,-,0,0
2009,손영민,KIA,2,0,0,0,-,0,0
2009,손정훈,KIA,1,0,0,0,-,0,0
2009,유동훈,KIA,4,0,0,0,-,0,0
2009,유용목,KIA,2,0,0,0,-,0,0
2009,윤석민,KIA,3,0,0,0,-,0,0
2009,이재주,KIA,51,0,0,0,-,0,0
2009,임준혁,KIA,1,0,0,0,-,0,0
2009,정성철,KIA,2,0,0,0,-,0,0
2009,김동수,히어로즈,29,0,0,0,-,0,0
2009,김지수,히어로즈,15,0,0,0,-,0,0
2009,손승현,히어로즈,4,0,0,0,-,0,0
2009,오윤,히어로즈,19,0,0,0,-,0,0
2009,오재일,히어로즈,43,0,0,0,-,0,0
2009,유선정,히어로즈,33,0,0,0,-,0,0
2009,유재신,히어로즈,9,0,0,0,-,0,0
2009,이보근,히어로즈,1,0,0,0,-,0,0
2009,장영석,히어로즈,16,0,0,0,-,0,0
2009,전동수,히어로즈,4,0,0,0,-,0,0
2009,조용훈,히어로즈,1,0,0,0,-,0,0
2009,조재호,히어로즈,21,0,0,0,-,0,0
2009,조중근,히어로즈,17,0,0,0,-,0,0
2009,허준,히어로즈,40,0,0,0,-,0,0
2009,황두성,히어로즈,1,0,0,0,-,0,0
2009,경헌호,LG,1,0,0,0,-,0,0
2009,곽용섭,LG,6,0,0,0,-,0,0
2009,김광삼,LG,1,0,0,0,-,0,0
2009,김민기,LG,1,0,0,0,-,0,0
2009,김정민,LG,26,1,0,1,0.0,0,0
2009,김태군,LG,54,0,0,0,-,0,0
2009,류택현,LG,1,0,0,0,-,0,0
2009,박종호,LG,62,0,0,0,-,0,0
2009,서동욱,LG,5,0,0,0,-,0,0
2009,오상민,LG,1,0,0,0,-,0,0
2009,오지환,LG,5,0,0,0,-,0,0
2009,오태근,LG,8,0,0,0,-,0,0
2009,우규민,LG,3,0,0,0,-,0,0
2009,윤진호,LG,3,0,0,0,-,0,0
2009,이경환,LG,6,0,0,0,-,0,0
2009,이동현,LG,1,0,0,0,-,0,0
2009,이병규,LG,16,0,0,0,-,0,0
2009,이재영,LG,3,0,0,0,-,0,0
2009,이종열,LG,12,0,0,0,-,0,0
2009,정주현,LG,6,0,0,0,-,0,0
2009,정찬헌,LG,3,0,0,0,-,0,0
2009,조인성,LG,95,2,0,2,0.0,0,0
2009,최동환,LG,3,0,0,0,-,0,0
2009,최성민,LG,1,0,0,0,-,0,0
2009,최원호,LG,1,0,0,0,-,0,0
2010,이대형,LG,130,87,66,21,75.9,0,0
2010,김주찬,롯데,118,84,65,19,77.4,0,0
2010,장기영,넥센,119,55,41,14,74.5,0,0
2010,오재원,두산,123,45,35,10,77.8,0,0
2010,정근우,SK,128,46,33,13,71.7,0,0
2010,조동찬,삼성,95,38,33,5,86.8,0,0
2010,이종욱,두산,114,43,30,13,69.8,0,0
2010,김상수,삼성,101,36,30,6,83.3,0,0
2010,이영욱,삼성,120,38,30,8,78.9,0,0
2010,김민우,넥센,128,34,28,6,82.4,0,0
2010,이용규,KIA,129,37,25,12,67.6,0,0
2010,전현태,한화,100,33,25,8,75.8,0,0
2010,김선빈,KIA,115,30,23,7,76.7,0,0
2010,김강민,SK,115,32,23,9,71.9,0,0
2010,김일경,넥센,104,27,21,6,77.8,0,0
2010,신명철,삼성,125,29,20,9,69.0,0,0
2010,박용택,LG,107,23,19,4,82.6,0,0
2010,안치홍,KIA,133,23,18,5,78.3,0,0
2010,황재균,롯데,94,25,18,7,72.0,0,0
2010,박정권,SK,124,22,17,5,77.3,0,0
2010,신종길,KIA,58,18,16,2,88.9,0,0
2010,전준우,롯데,114,23,16,7,69.6,0,0
2010,김원섭,KIA,111,21,15,6,71.4,0,0
2010,조동화,SK,115,17,15,2,88.2,0,0
2010,나주환,SK,100,20,14,6,70.0,0,0
2010,이택근,LG,91,20,14,6,70.0,0,0
2010,강동우,한화,98,20,14,6,70.0,0,0
2010,정원석,한화,118,23,14,9,60.9,0,0
2010,정수빈,두산,76,16,13,3,81.3,0,0
2010,오지환,LG,125,15,13,2,86.7,0,0
2010,최정,SK,123,16,12,4,75.0,0,0
2010,클락,넥센,92,19,12,7,63.2,0,0
2010,고영민,두산,100,14,11,3,78.6,0,0
2010,민병헌,두산,64,15,11,4,73.3,0,0
2010,박경수,LG,80,12,10,2,83.3,0,0
2010,이진영,LG,104,14,10,4,71.4,0,0
2010,추승우,한화,111,16,10,6,62.5,0,0
2010,박재상,SK,97,15,9,6,60.0,0,0
2010,김연훈,SK,73,12,8,4,66.7,0,0
2010,조성환,롯데,111,10,8,2,80.0,0,0
2010,강봉규,삼성,89,8,8,0,100.0,0,0
2010,박용근,LG,53,10,8,2,80.0,0,0
2010,김경언,한화,50,12,8,4,66.7,0,0
2010,김재현,SK,111,12,7,5,58.3,0,0
2010,임훈,SK,76,12,7,5,58.3,0,0
2010,최윤석,SK,47,8,7,1,87.5,0,0
2010,임재철,두산,96,10,7,3,70.0,0,0
2010,강명구,삼성,55,10,7,3,70.0,0,0
2010,김태완,한화,116,13,7,6,53.8,0,0
2010,오선진,한화,108,9,7,2,77.8,0,0
2010,이성열,두산,129,9,6,3,66.7,0,0
2010,손아섭,롯데,121,8,6,2,75.0,0,0
2010,조영훈,삼성,67,8,6,2,75.0,0,0
2010,신경현,한화,119,11,6,5,54.5,0,0
2010,모창민,SK,65,8,5,3,62.5,0,0
2010,김재호,두산,83,6,5,1,83.3,0,0
2010,박종윤,롯데,110,9,5,4,55.6,0,0
2010,박한이,삼성,128,9,5,4,55.6,0,0
2010,송지만,넥센,127,7,5,2,71.4,0,0
2010,이숭용,넥센,124,7,5,2,71.4,0,0
2010,박병호,LG,78,6,5,1,83.3,0,0
2010,이병규,LG,103,8,5,3,62.5,0,0
2010,이학준,LG,13,5,5,0,100.0,0,0
2010,이상훈,한화,34,6,5,1,83.3,0,0
2010,최진행,한화,129,9,5,4,55.6,0,0
2010,최희섭,KIA,126,7,4,3,57.1,0,0
2010,김현수,두산,132,12,4,8,33.3,0,0
2010,양의지,두산,127,5,4,1,80.0,0,0
2010,임익준,삼성,64,7,4,3,57.1,0,0
2010,최형우,삼성,121,4,4,0,100.0,0,0
2010,송광민,한화,77,8,4,4,50.0,0,0
2010,김상현,KIA,79,4,3,1,75.0,0,0
2010,나지완,KIA,109,5,3,2,60.0,0,0
2010,박기남,KIA,76,6,3,3,50.0,0,0
2010,가르시아,롯데,118,3,3,0,100.0,0,0
2010,황성용,롯데,44,3,3,0,100.0,0,0
2010,박석민,삼성,112,5,3,2,60.0,0,0
2010,이병규,LG,117,7,3,4,42.9,0,0
2010,정성훈,LG,111,4,3,1,75.0,0,0
2010,이양기,한화,27,3,3,0,100.0,0,0
2010,정현석,한화,114,6,3,3,50.0,0,0
2010,정희상,한화,29,3,3,0,100.0,0,0
2010,이종범,KIA,97,4,2,2,50.0,0,0
2010,최훈락,KIA,19,5,2,3,40.0,0,0
2010,권용관,SK,61,4,2,2,50.0,0,0
2010,안치용,SK,30,3,2,1,66.7,0,0
2010,강민호,롯데,117,9,2,7,22.2,0,0
2010,문규현,롯데,80,3,2,1,66.7,0,0
2010,박기혁,롯데,48,2,2,0,100.0,0,0
2010,이승화,롯데,92,3,2,1,66.7,0,0
2010,홍성흔,롯데,111,4,2,2,50.0,0,0
2010,이정식,삼성,50,2,2,0,100.0,0,0
2010,허승민,삼성,14,2,2,0,100.0,0,0
2010,강병식,넥센,107,4,2,2,50.0,0,0
2010,강병우,넥센,11,4,2,2,50.0,0,0
2010,강정호,넥센,133,4,2,2,50.0,0,0
2010,유선정,넥센,53,3,2,1,66.7,0,0
2010,유한준,넥센,131,4,2,2,50.0,0,0
2010,조인성,LG,133,2,2,0,100.0,0,0
2010,이대수,한화,125,6,2,4,33.3,0,0
2010,이희근,한화,82,4,2,2,50.0,0,0
2010,한윤섭,한화,30,2,2,0,100.0,0,0
2010,김다원,KIA,45,1,1,0,100.0,0,0
2010,김상훈,KIA,107,3,1,2,33.3,0,0
2010,차일목,KIA,91,2,1,1,50.0,0,0
2010,박경완,SK,129,2,1,1,50.0,0,0
2010,박재홍,SK,82,3,1,2,33.3,0,0
2010,이호준,SK,85,1,1,0,100.0,0,0
2010,이두환,두산,13,1,1,0,100.0,0,0
2010,이원석,두산,104,5,1,4,20.0,0,0
2010,박준서,롯데,22,1,1,0,100.0,0,0
2010,박진만,삼성,46,3,1,2,33.3,0,0
2010,배영섭,삼성,11,1,1,0,100.0,0,0
2010,오정복,삼성,100,5,1,4,20.0,0,0
2010,현재윤,삼성,53,2,1,1,50.0,0,0
2010,김민성,넥센,80,1,1,0,100.0,0,0
2010,정수성,넥센,8,1,1,0,100.0,0,0
2010,손인호,LG,42,1,1,0,100.0,0,0
2010,윤상균,LG,46,1,1,0,100.0,0,0
2010,정주현,LG,8,2,1,1,50.0,0,0
2010,전근표,한화,40,2,1,1,50.0,0,0
2010,김건한,KIA,3,0,0,0,-,0,0
2010,김형철,KIA,9,0,0,0,-,0,0
2010,박경태,KIA,6,0,0,0,-,0,0
2010,박성호,KIA,2,0,0,0,-,0,0
2010,손영민,KIA,2,0,0,0,-,0,0
2010,심동섭,KIA,1,0,0,0,-,0,0
2010,안영명,KIA,2,0,0,0,-,0,0
2010,유동훈,KIA,3,0,0,0,-,0,0
2010,윤석민,KIA,1,0,0,0,-,0,0
2010,윤효섭,KIA,1,0,0,0,-,0,0
2010,이성우,KIA,10,0,0,0,-,0,0
2010,이영수,KIA,42,0,0,0,-,0,0
2010,이종환,KIA,47,0,0,0,-,0,0
2010,이현곤,KIA,108,2,0,2,0.0,0,0
2010,임한용,KIA,2,0,0,0,-,0,0
2010,장태성,KIA,3,0,0,0,-,0,0
2010,조태수,KIA,4,0,0,0,-,0,0
2010,채종범,KIA,29,1,0,1,0.0,0,0
2010,최용규,KIA,22,0,0,0,-,0,0
2010,홍세완,KIA,10,0,0,0,-,0,0
2010,홍재호,KIA,24,0,0,0,-,0,0
2010,가득염,SK,1,0,0,0,-,0,0
2010,고효준,SK,2,0,0,0,-,0,0
2010,김광현,SK,1,0,0,0,-,0,0
2010,박상현,SK,1,0,0,0,-,0,0
2010,박정환,SK,44,2,0,2,0.0,0,0
2010,박희수,SK,1,0,0,0,-,0,0
2010,송은범,SK,1,0,0,0,-,0,0
2010,안경현,SK,8,0,0,0,-,0,0
2010,이명기,SK,4,0,0,0,-,0,0
2010,이승호,SK,2,0,0,0,-,0,0
2010,이재원,SK,54,0,0,0,-,0,0
2010,전병두,SK,1,0,0,0,-,0,0
2010,정상호,SK,35,0,0,0,-,0,0
2010,정우람,SK,1,0,0,0,-,0,0
2010,최경철,SK,1,0,0,0,-,0,0
2010,최동수,SK,56,1,0,1,0.0,0,0
2010,하지호,SK,9,0,0,0,-,0,0
2010,고창성,두산,3,0,0,0,-,0,0
2010,김동길,두산,8,0,0,0,-,0,0
2010,김동주,두산,110,1,0,1,0.0,0,0
2010,김승회,두산,2,0,0,0,-,0,0
2010,노경은,두산,1,0,0,0,-,0,0
2010,박정배,두산,2,0,0,0,-,0,0
2010,성영훈,두산,1,0,0,0,-,0,0
2010,손시헌,두산,128,2,0,2,0.0,0,0
2010,오현근,두산,3,0,0,0,-,0,0
2010,오현택,두산,1,0,0,0,-,0,0
2010,용덕한,두산,43,0,0,0,-,0,0
2010,유재웅,두산,53,0,0,0,-,0,0
2010,유희관,두산,1,0,0,0,-,0,0
2010,이용찬,두산,3,0,0,0,-,0,0
2010,이재학,두산,1,0,0,0,-,0,0
2010,임태훈,두산,1,0,0,0,-,0,0
2010,정재훈,두산,4,0,0,0,-,0,0
2010,조규수,두산,1,0,0,0,-,0,0
2010,조승수,두산,2,0,0,0,-,0,0
2010,최승환,두산,42,0,0,0,-,0,0
2010,최준석,두산,127,5,0,5,0.0,0,0
2010,홍상삼,두산,3,0,0,0,-,0,0
2010,강영식,롯데,1,0,0,0,-,0,0
2010,김사율,롯데,2,0,0,0,-,0,0
2010,박정준,롯데,2,0,0,0,-,0,0
2010,배장호,롯데,1,0,0,0,-,0,0
2010,변용선,롯데,3,0,0,0,-,0,0
2010,양종민,롯데,7,0,0,0,-,0,0
2010,이대호,롯데,127,2,0,2,0.0,0,0
2010,이인구,롯데,5,0,0,0,-,0,0
2010,이정민,롯데,1,0,0,0,-,0,0
2010,이정훈,롯데,4,0,0,0,-,0,0
2010,장성우,롯데,61,1,0,1,0.0,0,0
2010,정보명,롯데,30,1,0,1,0.0,0,0
2010,정훈,롯데,29,0,0,0,-,0,0
2010,허준혁,롯데,3,0,0,0,-,0,0
2010,권오준,삼성,1,0,0,0,-,0,0
2010,권혁,삼성,2,0,0,0,-,0,0
2010,김효남,삼성,1,0,0,0,-,0,0
2010,손주인,삼성,27,1,0,1,0.0,0,0
2010,양준혁,삼성,64,1,0,1,0.0,0,0
2010,윤성환,삼성,1,0,0,0,-,0,0
2010,장원삼,삼성,1,0,0,0,-,0,0
2010,정현욱,삼성,4,0,0,0,-,0,0
2010,정형식,삼성,7,1,0,1,0.0,0,0
2010,진갑용,삼성,100,0,0,0,-,0,0
2010,채상병,삼성,17,0,0,0,-,0,0
2010,채태인,삼성,102,3,0,3,0.0,0,0
2010,강귀태,넥센,97,2,0,2,0.0,0,0
2010,고원준,넥센,1,0,0,0,-,0,0
2010,권도영,넥센,37,1,0,1,0.0,0,0
2010,김성현,넥센,1,0,0,0,-,0,0
2010,김정훈,넥센,1,0,0,0,-,0,0
2010,김지수,넥센,8,0,0,0,-,0,0
2010,박동원,넥센,7,0,0,0,-,0,0
2010,박성훈,넥센,1,0,0,0,-,0,0
2010,박준수,넥센,1,0,0,0,-,0,0
2010,배힘찬,넥센,1,0,0,0,-,0,0
2010,손승락,넥센,3,0,0,0,-,0,0
2010,송신영,넥센,3,0,0,0,-,0,0
2010,오윤,넥센,37,1,0,1,0.0,0,0
2010,오재영,넥센,2,0,0,0,-,0,0
2010,오재일,넥센,39,0,0,0,-,0,0
2010,이보근,넥센,1,0,0,0,-,0,0
2010,이창섭,넥센,8,0,0,0,-,0,0
2010,장영석,넥센,64,0,0,0,-,0,0
2010,장종덕,넥센,2,0,0,0,-,0,0
2010,조재호,넥센,46,0,0,0,-,0,0
2010,조중근,넥센,21,0,0,0,-,0,0
2010,허준,넥센,73,1,0,1,0.0,0,0
2010,김선규,LG,2,0,0,0,-,0,0
2010,김준호,LG,21,0,0,0,-,0,0
2010,김태군,LG,50,0,0,0,-,0,0
2010,김태완,LG,72,2,0,2,0.0,0,0
2010,류택현,LG,1,0,0,0,-,0,0
2010,문선재,LG,7,0,0,0,-,0,0
2010,박동욱,LG,1,0,0,0,-,0,0
2010,박현준,LG,1,0,0,0,-,0,0
2010,백창수,LG,15,0,0,0,-,0,0
2010,서동욱,LG,11,0,0,0,-,0,0
2010,서성종,LG,4,0,0,0,-,0,0
2010,오카모토,LG,1,0,0,0,-,0,0
2010,윤진호,LG,17,0,0,0,-,0,0
2010,이상열,LG,1,0,0,0,-,0,0
2010,정재복,LG,1,0,0,0,-,0,0
2010,황선일,LG,4,0,0,0,-,0,0
2010,김강,한화,14,0,0,0,-,0,0
2010,김강석,한화,3,0,0,0,-,0,0
2010,김동영,한화,3,0,0,0,-,0,0
2010,김재우,한화,5,0,0,0,-,0,0
2010,김회성,한화,11,0,0,0,-,0,0
2010,데폴라,한화,4,0,0,0,-,0,0
2010,류현진,한화,2,0,0,0,-,0,0
2010,박노민,한화,21,0,0,0,-,0,0
2010,박정진,한화,3,0,0,0,-,0,0
2010,손지환,한화,25,2,0,2,0.0,0,0
2010,송창식,한화,1,0,0,0,-,0,0
2010,신해수,한화,1,0,0,0,-,0,0
2010,안승민,한화,2,0,0,0,-,0,0
2010,양훈,한화,3,0,0,0,-,0,0
2010,윤근영,한화,2,0,0,0,-,0,0
2010,이도형,한화,27,0,0,0,-,0,0
2010,이동현,한화,3,0,0,0,-,0,0
2010,이성호,한화,5,0,0,0,-,0,0
2010,이여상,한화,14,0,0,0,-,0,0
2010,이영우,한화,12,1,0,1,0.0,0,0
2010,장성호,한화,74,2,0,2,0.0,0,0
2010,정재원,한화,2,0,0,0,-,0,0
2010,허유강,한화,1,0,0,0,-,0,0
2010,황재규,한화,3,0,0,0,-,0,0
2011,오재원,두산,129,53,46,7,86.8,0,0
2011,이대형,LG,104,51,34,17,66.7,0,0
2011,배영섭,삼성,99,41,33,8,80.5,0,0
2011,정수빈,두산,128,39,31,8,79.5,0,0
2011,이용규,KIA,111,36,30,6,83.3,0,0
2011,김상수,삼성,128,36,29,7,80.6,0,0
2011,김주찬,롯데,86,35,25,10,71.4,0,0
2011,전준우,롯데,133,32,23,9,71.9,0,0
2011,신종길,KIA,116,29,23,6,79.3,0,0
2011,김민우,넥센,126,32,23,9,71.9,0,0
2011,김선빈,KIA,98,31,22,9,71.0,0,0
2011,정근우,SK,90,29,20,9,69.0,0,0
2011,이종욱,두산,121,35,20,15,57.1,0,0
2011,강명구,삼성,89,23,19,4,82.6,0,0
2011,조동찬,삼성,85,19,18,1,94.7,0,0
2011,강동우,한화,133,32,17,15,53.1,0,0
2011,한상훈,한화,131,26,16,10,61.5,0,0
2011,최정,SK,113,20,15,5,75.0,0,0
2011,이여상,한화,120,19,15,4,78.9,0,0
2011,이영욱,삼성,111,20,14,6,70.0,0,0
2011,박재상,SK,93,18,13,5,72.2,0,0
2011,신명철,삼성,117,23,13,10,56.5,0,0
2011,손아섭,롯데,116,17,13,4,76.5,0,0
2011,박용택,LG,115,16,13,3,81.3,0,0
2011,황재균,롯데,117,18,12,6,66.7,0,0
2011,김민성,넥센,124,15,12,3,80.0,0,0
2011,장기영,넥센,84,18,11,7,61.1,0,0
2011,조동화,SK,114,16,10,6,62.5,0,0
2011,박경수,LG,111,18,10,8,55.6,0,0
2011,이택근,LG,85,16,10,6,62.5,0,0
2011,김강민,SK,80,13,9,4,69.2,0,0
2011,박정권,SK,122,12,9,3,75.0,0,0
2011,조성환,롯데,117,15,9,6,60.0,0,0
2011,안치홍,KIA,115,13,9,4,69.2,0,0
2011,정성훈,LG,127,11,9,2,81.8,0,0
2011,김일경,넥센,41,16,9,7,56.3,0,0
2011,송지만,넥센,106,10,9,1,90.0,0,0
2011,박한이,삼성,121,10,8,2,80.0,0,0
2011,김상현,KIA,101,8,8,0,100.0,0,0
2011,오재필,한화,54,9,8,1,88.9,0,0
2011,이대수,한화,122,16,8,8,50.0,0,0
2011,조영훈,삼성,98,9,7,2,77.8,0,0
2011,서동욱,LG,112,8,7,1,87.5,0,0
2011,고종욱,넥센,54,13,7,6,53.8,0,0
2011,전현태,한화,78,11,7,4,63.6,0,0
2011,박진만,SK,100,11,6,5,54.5,0,0
2011,고영민,두산,93,12,6,6,50.0,0,0
2011,김동주,두산,120,7,6,1,85.7,0,0
2011,이인구,롯데,81,7,6,1,85.7,0,0
2011,알드리지,넥센,117,8,6,2,75.0,0,0
2011,임훈,SK,93,10,5,5,50.0,0,0
2011,김현수,두산,130,8,5,3,62.5,0,0
2011,문규현,롯데,125,7,5,2,71.4,0,0
2011,오지환,LG,63,7,5,2,71.4,0,0
2011,김경언,한화,81,10,5,5,50.0,0,0
2011,신경현,한화,103,9,5,4,55.6,0,0
2011,박재홍,SK,74,5,4,1,80.0,0,0
2011,최윤석,SK,82,8,4,4,50.0,0,0
2011,정형식,삼성,52,7,4,3,57.1,0,0
2011,최형우,삼성,133,7,4,3,57.1,0,0
2011,이성열,두산,83,10,4,6,40.0,0,0
2011,정진호,두산,47,4,4,0,100.0,0,0
2011,강민호,롯데,124,10,4,6,40.0,0,0
2011,박기남,KIA,85,6,4,2,66.7,0,0
2011,김태완,LG,76,5,4,1,80.0,0,0
2011,양영동,LG,51,5,4,1,80.0,0,0
2011,이학준,LG,33,7,4,3,57.1,0,0
2011,강정호,넥센,123,10,4,6,40.0,0,0
2011,유한준,넥센,121,7,4,3,57.1,0,0
2011,안치용,SK,93,3,3,0,100.0,0,0
2011,강봉규,삼성,52,4,3,1,75.0,0,0
2011,박석민,삼성,128,4,3,1,75.0,0,0
2011,양의지,두산,119,6,3,3,50.0,0,0
2011,박종윤,롯데,111,5,3,2,60.0,0,0
2011,이승화,롯데,70,4,3,1,75.0,0,0
2011,황성용,롯데,57,4,3,1,75.0,0,0
2011,윤정우,KIA,29,3,3,0,100.0,0,0
2011,이종범,KIA,97,5,3,2,60.0,0,0
2011,차일목,KIA,111,6,3,3,50.0,0,0
2011,이진영,LG,97,5,3,2,60.0,0,0
2011,정의윤,LG,93,5,3,2,60.0,0,0
2011,고동진,한화,97,5,3,2,60.0,0,0
2011,오선진,한화,68,6,3,3,50.0,0,0
2011,이양기,한화,93,3,3,0,100.0,0,0
2011,정원석,한화,82,6,3,3,50.0,0,0
2011,최진행,한화,127,8,3,5,37.5,0,0
2011,김연훈,SK,84,8,2,6,25.0,0,0
2011,이호준,SK,114,4,2,2,50.0,0,0
2011,손시헌,두산,92,3,2,1,66.7,0,0
2011,이대호,롯데,133,2,2,0,100.0,0,0
2011,홍성흔,롯데,132,7,2,5,28.6,0,0
2011,이범호,KIA,101,2,2,0,100.0,0,0
2011,윤진호,LG,75,3,2,1,66.7,0,0
2011,이병규,LG,127,3,2,1,66.7,0,0
2011,정주현,LG,15,2,2,0,100.0,0,0
2011,조인성,LG,117,3,2,1,66.7,0,0
2011,강병식,넥센,77,2,2,0,100.0,0,0
2011,박병호,넥센,66,2,2,0,100.0,0,0
2011,오재일,넥센,46,2,2,0,100.0,0,0
2011,조중근,넥센,36,3,2,1,66.7,0,0
2011,허도환,넥센,79,4,2,2,50.0,0,0
2011,김성현,SK,10,1,1,0,100.0,0,0
2011,박진원,SK,7,1,1,0,100.0,0,0
2011,허웅,SK,27,1,1,0,100.0,0,0
2011,진갑용,삼성,112,1,1,0,100.0,0,0
2011,채상병,삼성,63,2,1,1,50.0,0,0
2011,채태인,삼성,53,1,1,0,100.0,0,0
2011,김재호,두산,57,2,1,1,50.0,0,0
2011,김재환,두산,30,2,1,1,50.0,0,0
2011,이원석,두산,110,1,1,0,100.0,0,0
2011,김문호,롯데,19,2,1,1,50.0,0,0
2011,손용석,롯데,49,1,1,0,100.0,0,0
2011,김원섭,KIA,87,4,1,3,25.0,0,0
2011,김주형,KIA,88,1,1,0,100.0,0,0
2011,이현곤,KIA,104,2,1,1,50.0,0,0
2011,임한용,KIA,10,1,1,0,100.0,0,0
2011,최희섭,KIA,70,2,1,1,50.0,0,0
2011,홍재호,KIA,31,1,1,0,100.0,0,0
2011,백창수,LG,20,1,1,0,100.0,0,0
2011,이병규,LG,33,2,1,1,50.0,0,0
2011,강귀태,넥센,33,1,1,0,100,0,0
2011,오윤,넥센,57,2,1,1,50.0,0,0
2011,이숭용,넥센,88,1,1,0,100,0,0
2011,지석훈,넥센,52,4,1,3,25.0,0,0
2011,가르시아,한화,72,6,1,5,16.7,0,0
2011,박노민,한화,37,1,1,0,100,0,0
2011,백승룡,한화,38,2,1,1,50.0,0,0
2011,이희근,한화,75,1,1,0,100,0,0
2011,고효준,SK,1,0,0,0,-,0,0
2011,권용관,SK,28,1,0,1,0.0,0,0
2011,김용섭,SK,2,0,0,0,-,0,0
2011,김정남,SK,1,0,0,0,-,0,0
2011,김정훈,SK,3,0,0,0,-,0,0
2011,박경완,SK,10,0,0,0,-,0,0
2011,박윤,SK,10,0,0,0,-,0,0
2011,박정환,SK,9,0,0,0,-,0,0
2011,박희수,SK,1,0,0,0,-,0,0
2011,안정광,SK,15,0,0,0,-,0,0
2011,윤중환,SK,5,0,0,0,-,0,0
2011,이승호,SK,1,0,0,0,-,0,0
2011,이재영,SK,1,0,0,0,-,0,0
2011,전병두,SK,1,0,0,0,-,0,0
2011,전준호,SK,1,0,0,0,-,0,0
2011,정대현,SK,2,0,0,0,-,0,0
2011,정상호,SK,112,2,0,2,0.0,0,0
2011,정우람,SK,2,0,0,0,-,0,0
2011,정진기,SK,6,0,0,0,-,0,0
2011,조재호,SK,1,2,0,2,0.0,0,0
2011,최경철,SK,20,0,0,0,-,0,0
2011,최동수,SK,80,1,0,1,0.0,0,0
2011,홍명찬,SK,8,0,0,0,-,0,0
2011,가코,삼성,58,1,0,1,0.0,0,0
2011,권오준,삼성,1,0,0,0,-,0,0
2011,김정혁,삼성,3,0,0,0,-,0,0
2011,김종호,삼성,2,0,0,0,-,0,0
2011,김헌곤,삼성,11,0,0,0,-,0,0
2011,명재철,삼성,1,0,0,0,-,0,0
2011,모상기,삼성,32,0,0,0,-,0,0
2011,손주인,삼성,63,1,0,1,0.0,0,0
2011,오승환,삼성,4,0,0,0,-,0,0
2011,오정복,삼성,24,0,0,0,-,0,0
2011,이우선,삼성,2,0,0,0,-,0,0
2011,이정식,삼성,8,0,0,0,-,0,0
2011,현재윤,삼성,38,0,0,0,-,0,0
2011,김동길,두산,6,0,0,0,-,0,0
2011,김상현,두산,1,0,0,0,-,0,0
2011,김성배,두산,1,0,0,0,-,0,0
2011,박정배,두산,1,0,0,0,-,0,0
2011,안동현,두산,2,0,0,0,-,0,0
2011,용덕한,두산,60,0,0,0,-,0,0
2011,유재웅,두산,12,0,0,0,-,0,0
2011,윤석민,두산,80,2,0,2,0.0,0,0
2011,임재철,두산,36,2,0,2,0.0,0,0
2011,정대현,두산,1,0,0,0,-,0,0
2011,정재훈,두산,2,0,0,0,-,0,0
2011,최승환,두산,17,0,0,0,-,0,0
2011,최준석,두산,124,1,0,1,0.0,0,0
2011,김민하,롯데,2,0,0,0,-,0,0
2011,김사율,롯데,1,0,0,0,-,0,0
2011,김수완,롯데,1,0,0,0,-,0,0
2011,박준서,롯데,21,0,0,0,-,0,0
2011,박진환,롯데,11,0,0,0,-,0,0
2011,양종민,롯데,58,3,0,3,0.0,0,0
2011,오승택,롯데,1,0,0,0,-,0,0
2011,임경완,롯데,1,0,0,0,-,0,0
2011,장성우,롯데,64,0,0,0,-,0,0
2011,정보명,롯데,10,0,0,0,-,0,0
2011,정훈,롯데,26,1,0,1,0.0,0,0
2011,진명호,롯데,2,0,0,0,-,0,0
2011,허일,롯데,2,0,0,0,-,0,0
2011,허준혁,롯데,1,0,0,0,-,0,0
2011,고우석,KIA,1,0,0,0,-,0,0
2011,곽정철,KIA,2,0,0,0,-,0,0
2011,김다원,KIA,19,0,0,0,-,0,0
2011,김상훈,KIA,67,0,0,0,-,0,0
2011,김태훈,KIA,3,0,0,0,-,0,0
2011,나지완,KIA,85,1,0,1,0.0,0,0
2011,로페즈,KIA,1,0,0,0,-,0,0
2011,박성호,KIA,2,0,0,0,-,0,0
2011,유동훈,KIA,1,0,0,0,-,0,0
2011,유재원,KIA,10,0,0,0,-,0,0
2011,이상화,KIA,1,0,0,0,-,0,0
2011,이성우,KIA,15,0,0,0,-,0,0
2011,이준호,KIA,4,0,0,0,-,0,0
2011,임준혁,KIA,1,0,0,0,-,0,0
2011,정상교,KIA,7,0,0,0,-,0,0
2011,조태수,KIA,1,0,0,0,-,0,0
2011,차정민,KIA,1,0,0,0,-,0,0
2011,최훈락,KIA,35,0,0,0,-,0,0
2011,한기주,KIA,2,0,0,0,-,0,0
2011,홍건희,KIA,1,0,0,0,-,0,0
2011,김남석,LG,25,0,0,0,-,0,0
2011,김태군,LG,38,0,0,0,-,0,0
2011,박현준,LG,1,0,0,0,-,0,0
2011,손인호,LG,23,0,0,0,-,0,0
2011,송신영,LG,1,0,0,0,-,0,0
2011,심광호,LG,25,0,0,0,-,0,0
2011,유강남,LG,3,0,0,0,-,0,0
2011,윤상균,LG,67,0,0,0,-,0,0
2011,이대환,LG,1,0,0,0,-,0,0
2011,이동현,LG,1,0,0,0,-,0,0
2011,임찬규,LG,3,0,0,0,-,0,0
2011,정병곤,LG,11,0,0,0,-,0,0
2011,한희,LG,1,0,0,0,-,0,0
2011,황선일,LG,7,0,0,0,-,0,0
2011,김대우,넥센,1,0,0,0,-,0,0
2011,김도현,넥센,3,1,0,1,0.0,0,0
2011,김수경,넥센,1,0,0,0,-,0,0
2011,마정길,넥센,1,0,0,0,-,0,0
2011,박정준,넥센,50,1,0,1,0.0,0,0
2011,박헌도,넥센,7,0,0,0,-,0,0
2011,신현철,넥센,13,0,0,0,-,0,0
2011,심수창,넥센,1,0,0,0,-,0,0
2011,유선정,넥센,37,0,0,0,-,0,0
2011,이승주,넥센,3,0,0,0,-,0,0
2011,이정훈,넥센,1,0,0,0,-,0,0
2011,이해창,넥센,14,1,0,1,0.0,0,0
2011,장영석,넥센,35,0,0,0,-,0,0
2011,정범수,넥센,4,0,0,0,-,0,0
2011,조평호,넥센,5,0,0,0,-,0,0
2011,허준,넥센,55,1,0,1,0.0,0,0
2011,강경학,한화,2,0,0,0,-,0,0
2011,김강,한화,8,0,0,0,-,0,0
2011,김경태,한화,1,0,0,0,-,0,0
2011,김용호,한화,2,0,0,0,-,0,0
2011,김준호,한화,9,0,0,0,-,0,0
2011,김회성,한화,37,0,0,0,-,0,0
2011,나성용,한화,27,0,0,0,-,0,0
2011,데폴라,한화,2,0,0,0,-,0,0
2011,마일영,한화,2,0,0,0,-,0,0
2011,박정진,한화,1,0,0,0,-,0,0
2011,송창식,한화,1,0,0,0,-,0,0
2011,신주영,한화,3,0,0,0,-,0,0
2011,안영진,한화,1,0,0,0,-,0,0
2011,양훈,한화,1,0,0,0,-,0,0
2011,오넬리,한화,2,0,0,0,-,0,0
2011,오준혁,한화,2,0,0,0,-,0,0
2011,윤규진,한화,3,0,0,0,-,0,0
2011,윤근영,한화,2,0,0,0,-,0,0
2011,장민제,한화,1,0,0,0,-,0,0
2011,장성호,한화,116,6,0,6,0.0,0,0
2011,최진호,한화,1,0,0,0,-,0,0
2011,추승우,한화,19,0,0,0,-,0,0
2012,이용규,KIA,125,56,44,12,78.6,0,0
2012,서건창,넥센,127,51,39,12,76.5,0,0
2012,김주찬,롯데,118,45,32,13,71.1,0,0
2012,장기영,넥센,116,42,32,10,76.2,0,0
2012,김선빈,KIA,126,42,30,12,71.4,0,0
2012,박용택,LG,127,38,30,8,78.9,0,0
2012,배영섭,삼성,122,33,27,6,81.8,0,0
2012,황재균,롯데,133,34,26,8,76.5,0,0
2012,김상수,삼성,129,36,25,11,69.4,0,0
2012,이대형,LG,101,28,25,3,89.3,0,0
2012,정수빈,두산,101,30,24,6,80.0,0,0
2012,오지환,LG,133,37,23,14,62.2,0,0
2012,정형식,삼성,118,26,22,4,84.6,0,0
2012,정근우,SK,127,34,22,12,64.7,0,0
2012,전준우,롯데,122,29,21,8,72.4,0,0
2012,이종욱,두산,121,29,21,8,72.4,0,0
2012,강정호,넥센,124,26,21,5,80.8,0,0
2012,최정,SK,130,28,20,8,71.4,0,0
2012,안치홍,KIA,132,23,20,3,87.0,0,0
2012,박병호,넥센,133,29,20,9,69.0,0,0
2012,정수성,넥센,87,28,19,9,67.9,0,0
2012,강명구,삼성,72,18,15,3,83.3,0,0
2012,오재원,두산,77,16,14,2,87.5,0,0
2012,오선진,한화,110,23,14,9,60.9,0,0
2012,이택근,넥센,94,21,13,8,61.9,0,0
2012,조동찬,삼성,94,15,12,3,80.0,0,0
2012,김재현,SK,84,17,12,5,70.6,0,0
2012,양영동,LG,72,12,12,0,100.0,0,0
2012,김강민,SK,123,21,11,10,52.4,0,0
2012,손아섭,롯데,132,15,10,5,66.7,0,0
2012,허경민,두산,92,17,9,8,52.9,0,0
2012,이학준,한화,60,11,9,2,81.8,0,0
2012,김원섭,KIA,120,12,8,4,66.7,0,0
2012,정진호,두산,46,11,8,3,72.7,0,0
2012,고동진,한화,110,17,8,9,47.1,0,0
2012,이병규,LG,69,11,8,3,72.7,0,0
2012,나지완,KIA,124,10,7,3,70.0,0,0
2012,고영민,두산,58,8,7,1,87.5,0,0
2012,김경언,한화,110,11,7,4,63.6,0,0
2012,이여상,한화,86,9,7,2,77.8,0,0
2012,정범모,한화,72,12,7,5,58.3,0,0
2012,하주석,한화,70,9,7,2,77.8,0,0
2012,한상훈,한화,112,15,7,8,46.7,0,0
2012,김민성,넥센,71,9,7,2,77.8,0,0
2012,이승엽,삼성,126,6,6,0,100.0,0,0
2012,김성현,SK,88,8,6,2,75.0,0,0
2012,박재상,SK,100,15,6,9,40.0,0,0
2012,최윤석,SK,109,11,6,5,54.5,0,0
2012,김현수,두산,122,9,6,3,66.7,0,0
2012,양성우,한화,45,7,6,1,85.7,0,0
2012,오재필,한화,46,7,6,1,85.7,0,0
2012,최진행,한화,120,9,6,3,66.7,0,0
2012,강봉규,삼성,102,8,5,3,62.5,0,0
2012,박종윤,롯데,121,7,5,2,71.4,0,0
2012,박준서,롯데,87,6,5,1,83.3,0,0
2012,조성환,롯데,103,7,5,2,71.4,0,0
2012,신종길,KIA,44,10,5,5,50.0,0,0
2012,윤완주,KIA,68,8,5,3,62.5,0,0
2012,김용의,LG,83,9,5,4,55.6,0,0
2012,이대수,한화,118,6,5,1,83.3,0,0
2012,이병규,LG,118,12,5,7,41.7,0,0
2012,김민우,넥센,69,9,5,4,55.6,0,0
2012,오윤,넥센,94,7,5,2,71.4,0,0
2012,유재신,넥센,58,7,5,2,71.4,0,0
2012,이성열,넥센,104,11,5,6,45.5,0,0
2012,박한이,삼성,111,10,4,6,40.0,0,0
2012,박정권,SK,122,10,4,6,40.0,0,0
2012,홍성흔,롯데,113,9,4,5,44.4,0,0
2012,이준호,KIA,113,8,4,4,50.0,0,0
2012,손시헌,두산,86,6,4,2,66.7,0,0
2012,임재철,두산,66,6,4,2,66.7,0,0
2012,최주환,두산,81,7,4,3,57.1,0,0
2012,김일경,LG,44,5,4,1,80.0,0,0
2012,윤정우,LG,29,5,4,1,80.0,0,0
2012,이진영,LG,105,6,4,2,66.7,0,0
2012,정주현,LG,18,5,4,1,80.0,0,0
2012,박진만,SK,57,4,3,1,75.0,0,0
2012,안치용,SK,92,3,3,0,100.0,0,0
2012,이호준,SK,127,6,3,3,50.0,0,0
2012,임훈,SK,117,8,3,5,37.5,0,0
2012,조동화,SK,24,6,3,3,50.0,0,0
2012,용덕한,롯데,55,3,3,0,100.0,0,0
2012,김동주,두산,66,4,3,1,75.0,0,0
2012,김재호,두산,84,6,3,3,50.0,0,0
2012,김태균,한화,126,4,3,1,75.0,0,0
2012,백승룡,한화,33,3,3,0,100.0,0,0
2012,서동욱,LG,103,5,3,2,60.0,0,0
2012,윤요섭,LG,75,5,3,2,60.0,0,0
2012,정성훈,LG,107,6,3,3,50.0,0,0
2012,추승우,한화,18,3,3,0,100.0,0,0
2012,유한준,넥센,74,4,3,1,75.0,0,0
2012,박석민,삼성,127,5,2,3,40.0,0,0
2012,최형우,삼성,125,3,2,1,66.7,0,0
2012,모창민,SK,15,3,2,1,66.7,0,0
2012,황진수,롯데,28,2,2,0,100.0,0,0
2012,차일목,KIA,88,4,2,2,50.0,0,0
2012,김동한,두산,10,2,2,0,100.0,0,0
2012,윤석민,두산,109,3,2,1,66.7,0,0
2012,이천웅,LG,6,2,2,0,100.0,0,0
2012,장성호,한화,130,5,2,3,40.0,0,0
2012,정의윤,LG,81,4,2,2,50.0,0,0
2012,한윤섭,한화,23,2,2,0,100.0,0,0
2012,송지만,넥센,14,2,2,0,100.0,0,0
2012,김종호,삼성,22,1,1,0,100.0,0,0
2012,손주인,삼성,96,2,1,1,50.0,0,0
2012,신명철,삼성,44,3,1,2,33.3,0,0
2012,우동균,삼성,26,1,1,0,100.0,0,0
2012,채태인,삼성,54,2,1,1,50.0,0,0
2012,김문호,롯데,56,4,1,3,25.0,0,0
2012,신본기,롯데,50,2,1,1,50.0,0,0
2012,양종민,롯데,2,1,1,0,100.0,0,0
2012,이승화,롯데,65,3,1,2,33.3,0,0
2012,정훈,롯데,78,1,1,0,100.0,0,0
2012,황성용,롯데,73,1,1,0,100.0,0,0
2012,김상현,KIA,32,3,1,2,33.3,0,0
2012,박기남,KIA,99,1,1,0,100.0,0,0
2012,이범호,KIA,42,1,1,0,100.0,0,0
2012,이호신,KIA,27,1,1,0,100.0,0,0
2012,조영훈,KIA,89,3,1,2,33.3,0,0
2012,최희섭,KIA,80,2,1,1,50.0,0,0
2012,홍재호,KIA,55,1,1,0,100,0,0
2012,양의지,두산,122,3,1,2,33.3,0,0
2012,이원석,두산,107,2,1,1,50.0,0,0
2012,최준석,두산,89,1,1,0,100,0,0
2012,강동우,한화,76,3,1,2,33.3,0,0
2012,김영관,LG,6,1,1,0,100,0,0
2012,신경현,한화,76,1,1,0,100,0,0
2012,심광호,LG,43,2,1,1,50.0,0,0
2012,윤진호,LG,22,2,1,1,50.0,0,0
2012,이상훈,한화,17,1,1,0,100,0,0
2012,임익준,한화,10,1,1,0,100,0,0
2012,전현태,한화,2,1,1,0,100,0,0
2012,강병식,넥센,26,2,1,1,50.0,0,0
2012,조중근,넥센,45,3,1,2,33.3,0,0
2012,지석훈,넥센,61,2,1,1,50.0,0,0
2012,지재옥,넥센,29,1,1,0,100,0,0
2012,최경철,넥센,81,2,1,1,50.0,0,0
2012,김경모,삼성,9,1,0,1,0.0,0,0
2012,김동명,삼성,1,0,0,0,-,0,0
2012,김영훈,삼성,2,0,0,0,-,0,0
2012,김헌곤,삼성,10,0,0,0,-,0,0
2012,모상기,삼성,18,0,0,0,-,0,0
2012,성의준,삼성,2,0,0,0,-,0,0
2012,손형준,삼성,3,0,0,0,-,0,0
2012,심창민,삼성,1,0,0,0,-,0,0
2012,안지만,삼성,1,0,0,0,-,0,0
2012,오승환,삼성,3,0,0,0,-,0,0
2012,이정식,삼성,46,1,0,1,0.0,0,0
2012,이지영,삼성,54,0,0,0,-,0,0
2012,정현욱,삼성,1,0,0,0,-,0,0
2012,진갑용,삼성,114,0,0,0,-,0,0
2012,채상병,삼성,10,0,0,0,-,0,0
2012,권영진,SK,2,0,0,0,-,0,0
2012,권용관,SK,3,0,0,0,-,0,0
2012,김도현,SK,3,0,0,0,-,0,0
2012,김태훈,SK,1,0,0,0,-,0,0
2012,박경완,SK,8,0,0,0,-,0,0
2012,박승욱,SK,1,0,0,0,-,0,0
2012,박윤,SK,7,0,0,0,-,0,0
2012,박재홍,SK,46,1,0,1,0.0,0,0
2012,박희수,SK,1,0,0,0,-,0,0
2012,안정광,SK,6,1,0,1,0.0,0,0
2012,유재웅,SK,9,0,0,0,-,0,0
2012,이재원,SK,16,0,0,0,-,0,0
2012,정상호,SK,78,2,0,2,0.0,0,0
2012,정우람,SK,2,0,0,0,-,0,0
2012,정진기,SK,14,0,0,0,-,0,0
2012,조인성,SK,104,1,0,1,0.0,0,0
2012,조재호,SK,4,0,0,0,-,0,0
2012,최정민,SK,2,0,0,0,-,0,0
2012,한동민,SK,7,0,0,0,-,0,0
2012,홍명찬,SK,5,0,0,0,-,0,0
2012,강민호,롯데,119,1,0,1,0.0,0,0
2012,강영식,롯데,1,0,0,0,-,0,0
2012,권영준,롯데,11,0,0,0,-,0,0
2012,김대우,롯데,6,0,0,0,-,0,0
2012,김사율,롯데,1,0,0,0,-,0,0
2012,김사훈,롯데,17,0,0,0,-,0,0
2012,김상호,롯데,8,0,0,0,-,0,0
2012,김성배,롯데,1,0,0,0,-,0,0
2012,김수완,롯데,5,0,0,0,-,0,0
2012,문규현,롯데,105,2,0,2,0.0,0,0
2012,변용선,롯데,7,0,0,0,-,0,0
2012,사도스키,롯데,1,0,0,0,-,0,0
2012,손용석,롯데,43,0,0,0,-,0,0
2012,윤여운,롯데,15,0,0,0,-,0,0
2012,이명우,롯데,1,0,0,0,-,0,0
2012,이용훈,롯데,1,0,0,0,-,0,0
2012,이인구,롯데,7,0,0,0,-,0,0
2012,정보명,롯데,18,0,0,0,-,0,0
2012,최대성,롯데,1,0,0,0,-,0,0
2012,김상훈,KIA,80,0,0,0,-,0,0
2012,김주형,KIA,56,0,0,0,-,0,0
2012,송산,KIA,39,0,0,0,-,0,0
2012,오준형,KIA,1,0,0,0,-,0,0
2012,유동훈,KIA,1,0,0,0,-,0,0
2012,이성우,KIA,16,0,0,0,-,0,0
2012,이종환,KIA,6,0,0,0,-,0,0
2012,이현곤,KIA,6,0,0,0,-,0,0
2012,정상교,KIA,5,0,0,0,-,0,0
2012,진해수,KIA,3,0,0,0,-,0,0
2012,최훈락,KIA,25,0,0,0,-,0,0
2012,한기주,KIA,1,0,0,0,-,0,0
2012,한성구,KIA,17,0,0,0,-,0,0
2012,황정립,KIA,18,0,0,0,-,0,0
2012,국해성,두산,3,0,0,0,-,0,0
2012,김재환,두산,13,0,0,0,-,0,0
2012,김창훈,두산,1,0,0,0,-,0,0
2012,류지혁,두산,2,0,0,0,-,0,0
2012,민병헌,두산,2,2,0,2,0.0,0,0
2012,박세혁,두산,6,0,0,0,-,0,0
2012,변진수,두산,2,0,0,0,-,0,0
2012,안규영,두산,1,0,0,0,-,0,0
2012,오장훈,두산,10,0,0,0,-,0,0
2012,오재일,두산,87,0,0,0,-,0,0
2012,이혜천,두산,1,0,0,0,-,0,0
2012,최재훈,두산,69,0,0,0,-,0,0
2012,프록터,두산,6,0,0,0,-,0,0
2012,홍상삼,두산,2,0,0,0,-,0,0
2012,김광삼,LG,1,0,0,0,-,0,0
2012,김광수,한화,1,0,0,0,-,0,0
2012,김선규,LG,1,0,0,0,-,0,0
2012,김재율,LG,19,0,0,0,-,0,0
2012,김태군,LG,100,0,0,0,-,0,0
2012,김태완,LG,58,1,0,1,0.0,0,0
2012,류택현,LG,2,0,0,0,-,0,0
2012,마일영,한화,3,0,0,0,-,0,0
2012,바티스타,한화,3,0,0,0,-,0,0
2012,박노민,한화,19,0,0,0,-,0,0
2012,박정진,한화,4,0,0,0,-,0,0
2012,봉중근,LG,4,0,0,0,-,0,0
2012,서상우,LG,6,0,0,0,-,0,0
2012,션헨,한화,2,0,0,0,-,0,0
2012,손인호,LG,4,0,0,0,-,0,0
2012,송창식,한화,3,0,0,0,-,0,0
2012,신동훈,LG,1,0,0,0,-,0,0
2012,신정락,LG,1,0,0,0,-,0,0
2012,안승민,한화,4,0,0,0,-,0,0
2012,안영진,한화,1,0,0,0,-,0,0
2012,양훈,한화,1,0,0,0,-,0,0
2012,연경흠,한화,42,0,0,0,-,0,0
2012,오준혁,한화,10,0,0,0,-,0,0
2012,우규민,LG,2,0,0,0,-,0,0
2012,유강남,LG,13,0,0,0,-,0,0
2012,이동현,LG,3,0,0,0,-,0,0
2012,이민재,LG,7,0,0,0,-,0,0
2012,이상열,LG,2,0,0,0,-,0,0
2012,이승우,LG,1,0,0,0,-,0,0
2012,이양기,한화,35,0,0,0,-,0,0
2012,이준수,한화,37,0,0,0,-,0,0
2012,임찬규,LG,2,0,0,0,-,0,0
2012,정대훈,한화,1,0,0,0,-,0,0
2012,정민혁,한화,1,0,0,0,-,0,0
2012,정원석,한화,7,0,0,0,-,0,0
2012,조윤준,LG,23,0,0,0,-,0,0
2012,최동수,LG,94,1,0,1,0.0,0,0
2012,최승환,한화,24,0,0,0,-,0,0
2012,최영진,LG,43,0,0,0,-,0,0
2012,최우석,한화,1,0,0,0,-,0,0
2012,한희,LG,1,0,0,0,-,0,0
2012,황선일,LG,3,0,0,0,-,0,0
2012,강귀태,넥센,12,0,0,0,-,0,0
2012,김남형,넥센,6,0,0,0,-,0,0
2012,김병현,넥센,1,0,0,0,-,0,0
2012,김상수,넥센,3,0,0,0,-,0,0
2012,김수경,넥센,1,0,0,0,-,0,0
2012,김영민,넥센,2,0,0,0,-,0,0
2012,김정훈,넥센,1,0,0,0,-,0,0
2012,나이트,넥센,1,0,0,0,-,0,0
2012,문우람,넥센,25,0,0,0,-,0,0
2012,박성훈,넥센,2,0,0,0,-,0,0
2012,박정준,넥센,18,0,0,0,-,0,0
2012,박종윤,넥센,1,0,0,0,-,0,0
2012,박헌도,넥센,23,0,0,0,-,0,0
2012,손승락,넥센,4,0,0,0,-,0,0
2012,신현철,넥센,11,0,0,0,-,0,0
2012,오재영,넥센,1,0,0,0,-,0,0
2012,이정훈,넥센,3,0,0,0,-,0,0
2012,이태양,넥센,1,0,0,0,-,0,0
2012,임창민,넥센,1,0,0,0,-,0,0
2012,장영석,넥센,7,0,0,0,-,0,0
2012,장효훈,넥센,1,0,0,0,-,0,0
2012,차화준,넥센,8,0,0,0,-,0,0
2012,허도환,넥센,94,0,0,0,-,0,0
2013,김종호,NC,128,64,50,14,78.1,0,0
2013,손아섭,롯데,128,43,36,7,83.7,0,0
2013,오재원,두산,113,44,33,11,75.0,0,0
2013,이종욱,두산,110,37,30,7,81.1,0,0
2013,오지환,LG,124,37,30,7,81.1,0,0
2013,신종길,KIA,104,35,29,6,82.9,0,0
2013,이택근,넥센,123,37,29,8,78.4,0,0
2013,정근우,SK,112,39,28,11,71.8,0,0
2013,김선빈,KIA,88,42,28,14,66.7,0,0
2013,민병헌,두산,119,35,27,8,77.1,0,0
2013,서건창,넥센,86,33,26,7,78.8,0,0
2013,이상호,NC,103,29,25,4,86.2,0,0
2013,조동화,SK,105,33,24,9,72.7,0,0
2013,최정,SK,120,32,24,8,75.0,0,0
2013,배영섭,삼성,113,33,23,10,69.7,0,0
2013,정수빈,두산,125,31,23,8,74.2,0,0
2013,김주찬,KIA,47,26,23,3,88.5,0,0
2013,황재균,롯데,128,33,22,11,66.7,0,0
2013,이용규,KIA,100,30,21,9,70.0,0,0
2013,김용의,LG,109,28,21,7,75.0,0,0
2013,장기영,넥센,115,31,20,11,64.5,0,0
2013,전준우,롯데,128,27,19,8,70.4,0,0
2013,안치홍,KIA,118,17,16,1,94.1,0,0
2013,이학준,한화,97,19,16,3,84.2,0,0
2013,모창민,NC,108,19,16,3,84.2,0,0
2013,강정호,넥센,126,23,15,8,65.2,0,0
2013,김상수,삼성,115,19,14,5,73.7,0,0
2013,박재상,SK,103,15,14,1,93.3,0,0
2013,허경민,두산,75,18,14,4,77.8,0,0
2013,박용택,LG,125,21,13,8,61.9,0,0
2013,이대형,LG,102,22,13,9,59.1,0,0
2013,정성훈,LG,121,19,13,6,68.4,0,0
2013,추승우,한화,72,14,12,2,85.7,0,0
2013,나성범,NC,104,14,12,2,85.7,0,0
2013,강명구,삼성,55,12,11,1,91.7,0,0
2013,김재현,SK,33,13,11,2,84.6,0,0
2013,이대수,한화,122,15,11,4,73.3,0,0
2013,김강민,SK,105,16,10,6,62.5,0,0
2013,박병호,넥센,128,12,10,2,83.3,0,0
2013,정주현,LG,61,14,10,4,71.4,0,0
2013,김재호,두산,91,15,9,6,60.0,0,0
2013,손주인,LG,125,15,9,6,60.0,0,0
2013,박민우,NC,32,11,9,2,81.8,0,0
2013,김상현,SK,113,9,8,1,88.9,0,0
2013,김문호,롯데,40,13,8,5,61.5,0,0
2013,문선재,LG,93,13,8,5,61.5,0,0
2013,정형식,삼성,120,16,7,9,43.8,0,0
2013,조동찬,삼성,74,9,7,2,77.8,0,0
2013,정훈,롯데,113,10,7,3,70.0,0,0
2013,나지완,KIA,125,10,7,3,70.0,0,0
2013,김민성,넥센,128,14,7,7,50.0,0,0
2013,유재신,넥센,75,15,7,8,46.7,0,0
2013,이명기,SK,26,10,6,4,60.0,0,0
2013,조성우,SK,54,7,6,1,85.7,0,0
2013,양의지,두산,114,7,6,1,85.7,0,0
2013,이원석,두산,85,10,6,4,60.0,0,0
2013,신본기,롯데,99,9,6,3,66.7,0,0
2013,이진영,LG,106,8,6,2,75.0,0,0
2013,김동한,두산,26,5,5,0,100.0,0,0
2013,홍성흔,두산,127,8,5,3,62.5,0,0
2013,이승화,롯데,60,10,5,5,50.0,0,0
2013,정의윤,LG,116,9,5,4,55.6,0,0
2013,오선진,한화,92,7,5,2,71.4,0,0
2013,한상훈,한화,101,9,5,4,55.6,0,0
2013,박정준,NC,78,7,5,2,71.4,0,0
2013,박석민,삼성,117,6,4,2,66.7,0,0
2013,박한이,삼성,112,8,4,4,50.0,0,0
2013,이지영,삼성,113,4,4,0,100.0,0,0
2013,채태인,삼성,94,4,4,0,100.0,0,0
2013,박정권,SK,110,8,4,4,50.0,0,0
2013,강민호,롯데,105,5,4,1,80.0,0,0
2013,김대우,롯데,69,7,4,3,57.1,0,0
2013,박종윤,롯데,115,6,4,2,66.7,0,0
2013,백민기,롯데,30,6,4,2,66.7,0,0
2013,서동욱,넥센,104,6,4,2,66.7,0,0
2013,유한준,넥센,97,7,4,3,57.1,0,0
2013,양영동,LG,48,8,4,4,50.0,0,0
2013,고동진,한화,93,12,4,8,33.3,0,0
2013,정현석,한화,121,9,4,5,44.4,0,0
2013,조정원,한화,43,5,4,1,80.0,0,0
2013,권희동,NC,121,5,4,1,80.0,0,0
2013,조영훈,NC,120,9,4,5,44.4,0,0
2013,차화준,NC,58,6,4,2,66.7,0,0
2013,강봉규,삼성,32,3,3,0,100.0,0,0
2013,신명철,삼성,37,5,3,2,60.0,0,0
2013,우동균,삼성,82,4,3,1,75.0,0,0
2013,이승엽,삼성,111,4,3,1,75.0,0,0
2013,박진만,SK,100,7,3,4,42.9,0,0
2013,손시헌,두산,93,4,3,1,75.0,0,0
2013,조성환,롯데,74,4,3,1,75.0,0,0
2013,윤완주,KIA,47,5,3,2,60.0,0,0
2013,정수성,넥센,37,5,3,2,60.0,0,0
2013,최형우,삼성,128,3,2,1,66.7,0,0
2013,김성현,SK,97,8,2,6,25.0,0,0
2013,이재원,SK,69,3,2,1,66.7,0,0
2013,한동민,SK,99,5,2,3,40.0,0,0
2013,김현수,두산,122,6,2,4,33.3,0,0
2013,박건우,두산,34,5,2,3,40.0,0,0
2013,윤석민,두산,21,2,2,0,100.0,0,0
2013,임재철,두산,70,2,2,0,100.0,0,0
2013,문규현,롯데,79,2,2,0,100.0,0,0
2013,박준서,롯데,79,2,2,0,100.0,0,0
2013,임종혁,롯데,11,2,2,0,100.0,0,0
2013,조홍석,롯데,30,5,2,3,40.0,0,0
2013,고영우,KIA,29,3,2,1,66.7,0,0
2013,박기남,KIA,91,2,2,0,100.0,0,0
2013,문우람,넥센,69,4,2,2,50.0,0,0
2013,윤요섭,LG,89,5,2,3,40.0,0,0
2013,이병규,LG,98,4,2,2,50.0,0,0
2013,김경언,한화,70,7,2,5,28.6,0,0
2013,정범모,한화,88,3,2,1,66.7,0,0
2013,마낙길,NC,24,4,2,2,50.0,0,0
2013,이현곤,NC,91,2,2,0,100.0,0,0
2013,이호준,NC,126,5,2,3,40.0,0,0
2013,지석훈,NC,105,3,2,1,66.7,0,0
2013,최재원,NC,52,3,2,1,66.7,0,0
2013,김태완,삼성,83,2,1,1,50.0,0,0
2013,모상기,삼성,5,2,1,1,50.0,0,0
2013,이정식,삼성,11,1,1,0,100.0,0,0
2013,박승욱,SK,15,1,1,0,100.0,0,0
2013,안치용,SK,17,1,1,0,100.0,0,0
2013,정상호,SK,82,1,1,0,100.0,0,0
2013,고영민,두산,10,1,1,0,100.0,0,0
2013,김동주,두산,28,1,1,0,100.0,0,0
2013,최주환,두산,47,1,1,0,100.0,0,0
2013,박기혁,롯데,31,4,1,3,25.0,0,0
2013,용덕한,롯데,56,1,1,0,100.0,0,0
2013,황성용,롯데,34,1,1,0,100.0,0,0
2013,김원섭,KIA,42,1,1,0,100.0,0,0
2013,김주형,KIA,81,1,1,0,100.0,0,0
2013,유재혁,KIA,22,1,1,0,100.0,0,0
2013,이종환,KIA,42,1,1,0,100.0,0,0
2013,최훈락,KIA,16,1,1,0,100.0,0,0
2013,최희섭,KIA,78,2,1,1,50.0,0,0
2013,홍재호,KIA,85,3,1,2,33.3,0,0
2013,김민우,넥센,33,2,1,1,50.0,0,0
2013,김지수,넥센,37,1,1,0,100.0,0,0
2013,박동원,넥센,69,1,1,0,100.0,0,0
2013,이성열,넥센,92,3,1,2,33.3,0,0
2013,권용관,LG,68,1,1,0,100.0,0,0
2013,이병규,LG,73,2,1,1,50.0,0,0
2013,현재윤,LG,53,3,1,2,33.3,0,0
2013,김태완,한화,93,3,1,2,33.3,0,0
2013,박노민,한화,27,1,1,0,100.0,0,0
2013,송광민,한화,67,2,1,1,50.0,0,0
2013,엄태용,한화,39,1,1,0,100.0,0,0
2013,임익준,한화,36,4,1,3,25.0,0,0
2013,노진혁,NC,117,4,1,3,25.0,0,0
2013,박으뜸,NC,40,1,1,0,100.0,0,0
2013,조평호,NC,26,1,1,0,100.0,0,0
2013,김건한,삼성,2,0,0,0,-,0,0
2013,김동명,삼성,4,0,0,0,-,0,0
2013,김헌곤,삼성,7,0,0,0,-,0,0
2013,박찬도,삼성,3,0,0,0,-,0,0
2013,박해민,삼성,1,0,0,0,-,0,0
2013,배영수,삼성,1,0,0,0,-,0,0
2013,백상원,삼성,5,0,0,0,-,0,0
2013,성의준,삼성,16,1,0,1,0.0,0,0
2013,신용운,삼성,1,0,0,0,-,0,0
2013,심창민,삼성,1,0,0,0,-,0,0
2013,오승환,삼성,4,0,0,0,-,0,0
2013,이동걸,삼성,1,0,0,0,-,0,0
2013,이상훈,삼성,15,0,0,0,-,0,0
2013,이우선,삼성,1,0,0,0,-,0,0
2013,정병곤,삼성,54,0,0,0,-,0,0
2013,정현,삼성,8,0,0,0,-,0,0
2013,조현근,삼성,2,0,0,0,-,0,0
2013,진갑용,삼성,101,0,0,0,-,0,0
2013,김경근,SK,5,0,0,0,-,0,0
2013,김도현,SK,2,0,0,0,-,0,0
2013,김정훈,SK,4,0,0,0,-,0,0
2013,나주환,SK,15,0,0,0,-,0,0
2013,문승원,SK,3,0,0,0,-,0,0
2013,박경완,SK,8,0,0,0,-,0,0
2013,박인성,SK,2,0,0,0,-,0,0
2013,박정배,SK,1,0,0,0,-,0,0
2013,박희수,SK,2,0,0,0,-,0,0
2013,백인식,SK,1,0,0,0,-,0,0
2013,윤길현,SK,1,0,0,0,-,0,0
2013,이재영,SK,1,0,0,0,-,0,0
2013,임훈,SK,40,0,0,0,-,0,0
2013,전유수,SK,2,0,0,0,-,0,0
2013,정규창,SK,2,0,0,0,-,0,0
2013,정진기,SK,4,0,0,0,-,0,0
2013,조인성,SK,88,1,0,1,0.0,0,0
2013,진해수,SK,1,0,0,0,-,0,0
2013,최윤석,SK,45,2,0,2,0.0,0,0
2013,홍명찬,SK,5,0,0,0,-,0,0
2013,김상현,두산,1,0,0,0,-,0,0
2013,박세혁,두산,18,0,0,0,-,0,0
2013,오재일,두산,55,1,0,1,0.0,0,0
2013,오현근,두산,6,0,0,0,-,0,0
2013,원용묵,두산,1,0,0,0,-,0,0
2013,유희관,두산,1,0,0,0,-,0,0
2013,정재훈,두산,2,0,0,0,-,0,0
2013,최재훈,두산,60,0,0,0,-,0,0
2013,최준석,두산,100,0,0,0,-,0,0
2013,홍상삼,두산,1,0,0,0,-,0,0
2013,강영식,롯데,1,0,0,0,-,0,0
2013,고도현,롯데,4,0,0,0,-,0,0
2013,김사율,롯데,1,0,0,0,-,0,0
2013,김사훈,롯데,17,0,0,0,-,0,0
2013,김상호,롯데,25,0,0,0,-,0,0
2013,김성배,롯데,3,0,0,0,-,0,0
2013,김준태,롯데,4,0,0,0,-,0,0
2013,손용석,롯데,3,0,0,0,-,0,0
2013,송승준,롯데,1,0,0,0,-,0,0
2013,양종민,롯데,1,0,0,0,-,0,0
2013,이인구,롯데,2,0,0,0,-,0,0
2013,장성호,롯데,83,1,0,1,0.0,0,0
2013,정대현,롯데,2,0,0,0,-,0,0
2013,정보명,롯데,12,0,0,0,-,0,0
2013,황진수,롯데,2,0,0,0,-,0,0
2013,김광연,KIA,4,0,0,0,-,0,0
2013,김상훈,KIA,49,0,0,0,-,0,0
2013,박지훈,KIA,1,0,0,0,-,0,0
2013,백용환,KIA,26,0,0,0,-,0,0
2013,서용주,KIA,4,0,0,0,-,0,0
2013,송은범,KIA,2,0,0,0,-,0,0
2013,신승현,KIA,2,0,0,0,-,0,0
2013,신창호,KIA,1,0,0,0,-,0,0
2013,심동섭,KIA,1,0,0,0,-,0,0
2013,앤서니,KIA,2,0,0,0,-,0,0
2013,이동훈,KIA,13,0,0,0,-,0,0
2013,이범호,KIA,122,2,0,2,0.0,0,0
2013,이성우,KIA,15,0,0,0,-,0,0
2013,이준호,KIA,55,0,0,0,-,0,0
2013,이홍구,KIA,51,0,0,0,-,0,0
2013,차일목,KIA,98,2,0,2,0.0,0,0
2013,최향남,KIA,1,0,0,0,-,0,0
2013,한승혁,KIA,1,0,0,0,-,0,0
2013,황정립,KIA,21,0,0,0,-,0,0
2013,박종윤,넥센,1,0,0,0,-,0,0
2013,박헌도,넥센,9,0,0,0,-,0,0
2013,손승락,넥센,2,0,0,0,-,0,0
2013,송지만,넥센,34,0,0,0,-,0,0
2013,신현철,넥센,6,0,0,0,-,0,0
2013,안태영,넥센,12,0,0,0,-,0,0
2013,오윤,넥센,67,0,0,0,-,0,0
2013,조중근,넥센,10,0,0,0,-,0,0
2013,지재옥,넥센,18,0,0,0,-,0,0
2013,한현희,넥센,1,0,0,0,-,0,0
2013,허도환,넥센,116,2,0,2,0.0,0,0
2013,김영관,LG,2,0,0,0,-,0,0
2013,김재민,LG,10,0,0,0,-,0,0
2013,김효남,LG,1,0,0,0,-,0,0
2013,봉중근,LG,6,0,0,0,-,0,0
2013,신재웅,LG,1,0,0,0,-,0,0
2013,이상열,LG,2,0,0,0,-,0,0
2013,이천웅,LG,8,0,0,0,-,0,0
2013,임도현,LG,1,0,0,0,-,0,0
2013,임정우,LG,5,0,0,0,-,0,0
2013,임찬규,LG,3,0,0,0,-,0,0
2013,정현욱,LG,3,0,0,0,-,0,0
2013,조윤준,LG,19,0,0,0,-,0,0
2013,최경철,LG,38,1,0,1,0.0,0,0
2013,최동수,LG,2,0,0,0,-,0,0
2013,최승준,LG,2,0,0,0,-,0,0
2013,최영진,LG,6,0,0,0,-,0,0
2013,강동우,한화,26,0,0,0,-,0,0
2013,김광수,한화,1,0,0,0,-,0,0
2013,김태균,한화,101,3,0,3,0.0,0,0
2013,김혁민,한화,1,0,0,0,-,0,0
2013,박상규,한화,5,0,0,0,-,0,0
2013,박정진,한화,1,0,0,0,-,0,0
2013,백승룡,한화,2,0,0,0,-,0,0
2013,송주호,한화,28,2,0,2,0.0,0,0
2013,송창식,한화,4,0,0,0,-,0,0
2013,송창현,한화,1,0,0,0,-,0,0
2013,양성우,한화,1,0,0,0,-,0,0
2013,연경흠,한화,4,0,0,0,-,0,0
2013,오재필,한화,9,0,0,0,-,0,0
2013,윤근영,한화,1,0,0,0,-,0,0
2013,이브랜드,한화,1,0,0,0,-,0,0
2013,이양기,한화,56,0,0,0,-,0,0
2013,이여상,한화,14,0,0,0,-,0,0
2013,이준수,한화,47,0,0,0,-,0,0
2013,임경훈,한화,7,0,0,0,-,0,0
2013,임기영,한화,3,0,0,0,-,0,0
2013,임세업,한화,5,1,0,1,0.0,0,0
2013,장운호,한화,11,1,0,1,0.0,0,0
2013,전현태,한화,21,0,0,0,-,0,0
2013,조지훈,한화,2,0,0,0,-,0,0
2013,최승환,한화,10,0,0,0,-,0,0
2013,최진행,한화,106,0,0,0,-,0,0
2013,하주석,한화,5,1,0,1,0.0,0,0
2013,한승택,한화,24,0,0,0,-,0,0
2013,강구성,NC,2,0,0,0,-,0,0
2013,강진성,NC,3,0,0,0,-,0,0
2013,김동건,NC,8,0,0,0,-,0,0
2013,김성욱,NC,4,0,0,0,-,0,0
2013,김종찬,NC,5,0,0,0,-,0,0
2013,김준완,NC,3,0,0,0,-,0,0
2013,김진성,NC,2,0,0,0,-,0,0
2013,김태군,NC,112,2,0,2,0.0,0,0
2013,김태우,NC,7,0,0,0,-,0,0
2013,노성호,NC,1,0,0,0,-,0,0
2013,박상혁,NC,8,0,0,0,-,0,0
2013,박헌욱,NC,2,0,0,0,-,0,0
2013,손민한,NC,2,0,0,0,-,0,0
2013,이명환,NC,5,0,0,0,-,0,0
2013,이민호,NC,1,0,0,0,-,0,0
2013,이승호,NC,2,0,0,0,-,0,0
2013,이재학,NC,1,0,0,0,-,0,0
2013,이창섭,NC,5,0,0,0,-,0,0
2013,이태원,NC,70,0,0,0,-,0,0
2013,임창민,NC,2,0,0,0,-,0,0
2013,정진,NC,1,0,0,0,-,0,0
2013,최금강,NC,1,0,0,0,-,0,0
2013,허준,NC,14,0,0,0,-,0,0
2014,김상수,삼성,128,59,53,6,89.8,6,2
2014,박민우,NC,118,60,50,10,83.3,5,2
2014,서건창,넥센,128,65,48,17,73.8,12,3
2014,조동화,SK,125,44,37,7,84.1,2,4
2014,박해민,삼성,119,44,36,8,81.8,6,3
2014,오재원,두산,110,40,33,7,82.5,7,2
2014,정수빈,두산,128,37,32,5,86.5,2,4
2014,김강민,SK,113,37,32,5,86.5,7,2
2014,정근우,한화,125,35,32,3,91.4,5,0
2014,오지환,LG,113,40,28,12,70.0,4,1
2014,나바로,삼성,125,34,25,9,73.5,8,0
2014,김종호,NC,113,29,22,7,75.9,4,1
2014,김주찬,KIA,100,32,22,10,68.8,7,0
2014,이대형,KIA,126,37,22,15,59.5,8,1
2014,신종길,KIA,103,27,20,7,74.1,2,2
2014,안치홍,KIA,126,25,19,6,76.0,5,1
2014,황재균,롯데,128,27,17,10,63.0,5,0
2014,민병헌,두산,124,24,16,8,66.7,5,0
2014,이종욱,NC,124,19,15,4,78.9,3,0
2014,나성범,NC,123,19,14,5,73.7,3,1
2014,모창민,NC,122,17,14,3,82.4,4,0
2014,이용규,한화,104,23,12,11,52.2,4,2
2014,박용택,LG,124,20,11,9,55.0,5,1
2014,이택근,넥센,122,19,11,8,57.9,5,3
2014,이상호,NC,96,16,11,5,68.8,3,0
2014,테임즈,NC,125,13,11,2,84.6,5,1
2014,정성훈,LG,112,12,10,2,83.3,7,1
2014,손아섭,롯데,122,13,10,3,76.9,0,0
2014,나주환,SK,127,13,10,3,76.9,3,0
2014,필,KIA,92,11,10,1,90.9,3,1
2014,김용의,LG,103,16,9,7,56.3,1,1
2014,임훈,SK,90,11,9,2,81.8,5,0
2014,피에,한화,119,20,9,11,45.0,6,0
2014,박병호,넥센,128,11,8,3,72.7,2,0
2014,정훈,롯데,124,12,8,4,66.7,4,0
2014,김재현,SK,60,9,8,1,88.9,2,0
2014,이명기,SK,83,14,8,6,57.1,2,1
2014,박한이,삼성,125,13,7,6,53.8,6,0
2014,박경수,LG,87,8,7,1,87.5,2,0
2014,전준우,롯데,113,11,7,4,63.6,7,1
2014,박계현,SK,62,10,7,3,70.0,3,2
2014,박정권,SK,120,16,7,9,43.8,10,1
2014,최정,SK,82,9,7,2,77.8,1,0
2014,김민우,KIA,87,9,7,2,77.8,3,0
2014,박찬도,삼성,28,8,6,2,75.0,2,2
2014,이영욱,삼성,40,7,6,1,85.7,0,0
2014,허경민,두산,105,10,6,4,60.0,2,0
2014,유재신,넥센,23,8,6,2,75.0,1,0
2014,김성현,SK,122,9,6,3,66.7,2,0
2014,권희동,NC,101,7,6,1,85.7,1,0
2014,이승엽,삼성,127,6,5,1,83.3,4,0
2014,조동찬,삼성,31,7,5,2,71.4,2,1
2014,장민석,두산,45,6,5,1,83.3,0,0
2014,홍성흔,두산,124,8,5,3,62.5,6,0
2014,이병규,LG,116,15,5,10,33.3,6,3
2014,정의윤,LG,97,9,5,4,55.6,3,0
2014,채은성,LG,62,8,5,3,62.5,4,0
2014,문우람,넥센,122,8,5,3,62.5,7,1
2014,문규현,롯데,77,7,5,2,71.4,3,0
2014,정형식,삼성,52,6,4,2,66.7,0,2
2014,최형우,삼성,113,6,4,2,66.7,4,0
2014,양의지,두산,97,7,4,3,57.1,3,0
2014,손주인,LG,120,6,4,2,66.7,4,1
2014,이진영,LG,119,7,4,3,57.1,5,0
2014,최경철,LG,117,6,4,2,66.7,0,0
2014,김하성,넥센,60,7,4,3,57.1,1,0
2014,김문호,롯데,71,4,4,0,100.0,5,0
2014,강한울,KIA,93,6,4,2,66.7,4,0
2014,이학준,한화,45,5,4,1,80.0,1,0
2014,강명구,삼성,21,4,3,1,75.0,0,0
2014,이지영,삼성,99,6,3,3,50.0,5,0
2014,문선재,LG,22,3,3,0,100.0,1,0
2014,백창수,LG,51,7,3,4,42.9,0,1
2014,조쉬벨,LG,63,3,3,0,100.0,5,0
2014,강정호,넥센,117,6,3,3,50.0,7,1
2014,김민성,넥센,116,4,3,1,75.0,3,1
2014,김민하,롯데,55,4,3,1,75.0,1,0
2014,이재원,SK,120,3,3,0,100.0,3,0
2014,이호준,NC,122,8,3,5,37.5,4,0
2014,김원섭,KIA,44,4,3,1,75.0,0,0
2014,나지완,KIA,118,6,3,3,50.0,8,0
2014,송광민,한화,103,5,3,2,60.0,6,0
2014,한상훈,한화,77,4,3,1,75.0,3,0
2014,김헌곤,삼성,76,4,2,2,50.0,5,0
2014,김재호,두산,122,10,2,8,20.0,5,0
2014,김현수,두산,125,2,2,0,100.0,5,0
2014,황목치승,LG,37,4,2,2,50.0,1,0
2014,로티노,넥센,79,2,2,0,100.0,0,1
2014,박헌도,넥센,47,2,2,0,100.0,1,1
2014,유한준,넥센,122,3,2,1,66.7,5,0
2014,이성열,넥센,96,5,2,3,40.0,2,0
2014,오승택,롯데,57,3,2,1,66.7,2,1
2014,임종혁,롯데,21,4,2,2,50.0,1,0
2014,박재상,SK,38,3,2,1,66.7,1,0
2014,손시헌,NC,97,3,2,1,66.7,1,0
2014,오정복,NC,47,2,2,0,100.0,0,1
2014,김다원,KIA,86,4,2,2,50.0,4,0
2014,김선빈,KIA,33,2,2,0,100.0,1,1
2014,박기남,KIA,90,7,2,5,28.6,4,1
2014,박준태,KIA,32,2,2,0,100.0,0,0
2014,이범호,KIA,105,4,2,2,50.0,3,0
2014,이흥련,삼성,88,1,1,0,100.0,1,0
2014,채태인,삼성,124,1,1,0,100.0,3,0
2014,고영민,두산,52,2,1,1,50.0,3,0
2014,김재환,두산,52,1,1,0,100.0,1,0
2014,박건우,두산,47,1,1,0,100.0,0,0
2014,오재일,두산,75,2,1,1,50.0,0,0
2014,최주환,두산,82,2,1,1,50.0,5,0
2014,칸투,두산,111,1,1,0,100.0,3,0
2014,박용근,LG,27,1,1,0,100.0,0,0
2014,이병규,LG,62,2,1,1,50.0,0,0
2014,고종욱,넥센,8,1,1,0,100.0,0,1
2014,김지수,넥센,28,1,1,0,100.0,0,0
2014,서동욱,넥센,39,1,1,0,100.0,1,0
2014,안태영,넥센,41,1,1,0,100.0,0,0
2014,강민호,롯데,98,3,1,2,33.3,3,0
2014,김대우,롯데,18,1,1,0,100.0,1,0
2014,신본기,롯데,63,2,1,1,50.0,2,0
2014,최준석,롯데,121,1,1,0,100.0,1,0
2014,하준호,롯데,31,2,1,1,50.0,0,0
2014,김상현,SK,42,2,1,1,50.0,1,0
2014,신현철,SK,60,1,1,0,100,1,0
2014,안정광,SK,15,2,1,1,50.0,0,0
2014,김성욱,NC,26,1,1,0,100,0,0
2014,김준완,NC,6,1,1,0,100,0,0
2014,조영훈,NC,92,2,1,1,50.0,0,0
2014,지석훈,NC,114,2,1,1,50.0,4,1
2014,이성우,KIA,63,1,1,0,100,1,0
2014,김경언,한화,89,4,1,3,25.0,2,0
2014,송주호,한화,17,1,1,0,100,1,0
2014,이양기,한화,45,1,1,0,100,1,0
2014,이창열,한화,22,1,1,0,100,1,1
2014,장운호,한화,39,2,1,1,50.0,2,0
2014,정범모,한화,85,1,1,0,100,1,0
2014,최진행,한화,99,3,1,2,33.3,1,0
2014,권혁,삼성,1,0,0,0,-,0,0
2014,김건한,삼성,1,0,0,0,-,0,0
2014,김기태,삼성,1,0,0,0,-,0,0
2014,김재현,삼성,8,0,0,0,-,1,0
2014,김정혁,삼성,2,0,0,0,-,0,0
2014,김태완,삼성,65,0,0,0,-,3,0
2014,김희석,삼성,2,0,0,0,-,0,0
2014,문선엽,삼성,3,0,0,0,-,0,0
2014,박근홍,삼성,1,0,0,0,-,0,0
2014,박석민,삼성,110,1,0,1,0.0,4,0
2014,백상원,삼성,31,0,0,0,-,0,0
2014,백정현,삼성,1,0,0,0,-,0,0
2014,밴덴헐크,삼성,1,0,0,0,-,0,0
2014,심창민,삼성,1,0,0,0,-,0,0
2014,안지만,삼성,1,0,0,0,-,0,0
2014,우동균,삼성,30,0,0,0,-,0,0
2014,이상훈,삼성,10,0,0,0,-,0,0
2014,이정식,삼성,7,0,0,0,-,0,0
2014,임창용,삼성,1,0,0,0,-,0,0
2014,정현,삼성,5,0,0,0,-,0,0
2014,조현근,삼성,1,0,0,0,-,0,0
2014,진갑용,삼성,11,0,0,0,-,0,0
2014,김응민,두산,11,0,0,0,-,0,0
2014,김진형,두산,28,0,0,0,-,0,0
2014,니퍼트,두산,1,0,0,0,-,0,0
2014,양종민,두산,5,0,0,0,-,0,0
2014,오장훈,두산,1,0,0,0,-,0,0
2014,이성곤,두산,4,0,0,0,-,0,0
2014,이용찬,두산,2,0,0,0,-,0,0
2014,이원석,두산,79,0,0,0,-,1,0
2014,이현승,두산,1,0,0,0,-,0,0
2014,최병욱,두산,1,0,0,0,-,0,0
2014,최영진,두산,4,0,0,0,-,0,0
2014,최재훈,두산,48,2,0,2,0.0,2,0
2014,권용관,LG,8,0,0,0,-,0,0
2014,김영관,LG,13,0,0,0,-,1,0
2014,김재민,LG,38,0,0,0,-,0,0
2014,봉중근,LG,3,0,0,0,-,0,0
2014,스나이더,LG,37,2,0,2,0.0,1,0
2014,신승현,LG,1,0,0,0,-,0,0
2014,신재웅,LG,1,0,0,0,-,0,0
2014,유원상,LG,1,0,0,0,-,0,0
2014,윤요섭,LG,27,0,0,0,-,0,0
2014,윤지웅,LG,1,0,0,0,-,0,0
2014,이동현,LG,2,0,0,0,-,0,0
2014,임재철,LG,53,0,0,0,-,0,0
2014,정찬헌,LG,2,0,0,0,-,0,0
2014,조윤준,LG,5,0,0,0,-,0,0
2014,최승준,LG,20,0,0,0,-,0,0
2014,현재윤,LG,14,0,0,0,-,1,0
2014,강지광,넥센,1,0,0,0,-,0,0
2014,박동원,넥센,76,0,0,0,-,1,0
2014,배힘찬,넥센,1,0,0,0,-,0,0
2014,손승락,넥센,1,0,0,0,-,0,0
2014,오윤,넥센,6,0,0,0,-,0,0
2014,윤석민,넥센,99,0,0,0,-,0,1
2014,임태준,넥센,17,0,0,0,-,1,0
2014,허도환,넥센,93,0,0,0,-,4,0
2014,홍성갑,넥센,2,0,0,0,-,1,0
2014,강영식,롯데,1,0,0,0,-,0,0
2014,고도현,롯데,4,0,0,0,-,0,0
2014,김사훈,롯데,4,0,0,0,-,0,0
2014,김승회,롯데,1,0,0,0,-,0,0
2014,김주현,롯데,9,0,0,0,-,0,0
2014,박기혁,롯데,22,1,0,1,0.0,0,0
2014,박종윤,롯데,123,2,0,2,0.0,5,0
2014,박준서,롯데,74,0,0,0,-,0,0
2014,백민기,롯데,9,1,0,1,0.0,0,0
2014,손용석,롯데,3,0,0,0,-,0,0
2014,송승준,롯데,1,0,0,0,-,0,0
2014,심수창,롯데,1,0,0,0,-,0,0
2014,용덕한,롯데,59,1,0,1,0.0,1,0
2014,이승화,롯데,44,3,0,3,0.0,3,0
2014,이창진,롯데,4,0,0,0,-,0,0
2014,장성우,롯데,43,0,0,0,-,0,0
2014,장성호,롯데,5,0,0,0,-,0,0
2014,장원준,롯데,1,0,0,0,-,0,0
2014,정대현,롯데,2,0,0,0,-,0,0
2014,조성환,롯데,6,0,0,0,-,0,0
2014,조홍석,롯데,2,0,0,0,-,0,0
2014,최대성,롯데,1,0,0,0,-,0,0
2014,황동채,롯데,12,0,0,0,-,0,0
2014,황진수,롯데,5,0,0,0,-,0,0
2014,히메네스,롯데,80,2,0,2,0.0,5,0
2014,김도현,SK,7,0,0,0,-,0,0
2014,김정훈,SK,1,0,0,0,-,0,0
2014,박민호,SK,1,0,0,0,-,0,0
2014,박윤,SK,6,0,0,0,-,1,0
2014,박정배,SK,1,0,0,0,-,0,0
2014,박진만,SK,19,1,0,1,0.0,0,0
2014,박희수,SK,2,0,0,0,-,0,0
2014,스캇,SK,33,0,0,0,-,1,0
2014,여건욱,SK,1,0,0,0,-,0,0
2014,이대수,SK,15,0,0,0,-,0,0
2014,이재영,SK,1,0,0,0,-,0,0
2014,이한진,SK,1,0,0,0,-,0,0
2014,임경완,SK,1,0,0,0,-,0,0
2014,정상호,SK,100,1,0,1,0.0,2,0
2014,조성우,SK,3,0,0,0,-,0,0
2014,한동민,SK,67,0,0,0,-,2,1
2014,허웅,SK,5,0,0,0,-,0,0
2014,홍명찬,SK,10,0,0,0,-,0,0
2014,강민국,NC,6,0,0,0,-,0,0
2014,고창성,NC,1,0,0,0,-,0,0
2014,김진성,NC,4,0,0,0,-,0,0
2014,김태군,NC,109,1,0,1,0.0,5,0
2014,김태우,NC,5,0,0,0,-,0,0
2014,노진혁,NC,26,1,0,1,0.0,0,0
2014,마낙길,NC,2,0,0,0,-,0,0
2014,박명환,NC,2,0,0,0,-,0,0
2014,박정준,NC,39,0,0,0,-,1,0
2014,손민한,NC,1,0,0,0,-,0,0
2014,손정욱,NC,1,0,0,0,-,0,0
2014,이승재,NC,12,0,0,0,-,1,0
2014,이창섭,NC,1,0,0,0,-,0,0
2014,이태양,NC,1,0,0,0,-,0,0
2014,이태원,NC,62,0,0,0,-,0,0
2014,이현곤,NC,7,0,0,0,-,0,0
2014,이혜천,NC,1,0,0,0,-,0,0
2014,임창민,NC,2,0,0,0,-,0,0
2014,조평호,NC,2,0,0,0,-,0,0
2014,최금강,NC,1,0,0,0,-,0,0
2014,최재원,NC,2,0,0,0,-,0,0
2014,허준,NC,28,0,0,0,-,0,0
2014,홍성용,NC,2,0,0,0,-,0,0
2014,고영우,KIA,21,0,0,0,-,0,0
2014,김광연,KIA,8,0,0,0,-,0,0
2014,김병현,KIA,1,0,0,0,-,0,0
2014,김상훈,KIA,9,0,0,0,-,0,0
2014,김주형,KIA,64,3,0,3,0.0,3,0
2014,김지훈,KIA,1,0,0,0,-,0,0
2014,김진우,KIA,1,0,0,0,-,0,0
2014,김태영,KIA,1,0,0,0,-,0,0
2014,박성호,KIA,1,0,0,0,-,0,0
2014,박찬호,KIA,17,0,0,0,-,0,0
2014,백용환,KIA,47,0,0,0,-,1,0
2014,송은범,KIA,2,0,0,0,-,0,0
2014,신창호,KIA,2,0,0,0,-,0,0
2014,심동섭,KIA,1,0,0,0,-,0,0
2014,어센시오,KIA,3,0,0,0,-,0,0
2014,오두철,KIA,2,0,0,0,-,0,0
2014,윤완주,KIA,5,0,0,0,-,0,0
2014,이종환,KIA,92,2,0,2,0.0,0,0
2014,임준섭,KIA,1,0,0,0,-,0,0
2014,임준혁,KIA,1,0,0,0,-,0,0
2014,차일목,KIA,94,2,0,2,0.0,2,0
2014,한승혁,KIA,1,0,0,0,-,0,0
2014,강경학,한화,41,0,0,0,-,1,0
2014,고동진,한화,73,2,0,2,0.0,3,0
2014,김민수,한화,35,0,0,0,-,1,0
2014,김태균,한화,118,2,0,2,0.0,5,0
2014,김태완,한화,89,0,0,0,-,0,0
2014,김회성,한화,59,0,0,0,-,1,0
2014,노수광,한화,1,0,0,0,-,0,0
2014,박노민,한화,2,0,0,0,-,0,0
2014,박정진,한화,1,0,0,0,-,0,0
2014,박준혁,한화,2,0,0,0,-,0,0
2014,송창식,한화,1,0,0,0,-,0,0
2014,엄태용,한화,17,0,0,0,-,0,0
2014,윤규진,한화,1,0,0,0,-,0,0
2014,이준수,한화,3,0,0,0,-,0,0
2014,이희근,한화,6,0,0,0,-,0,0
2014,임익준,한화,6,0,0,0,-,0,0
2014,전현태,한화,10,0,0,0,-,0,0
2014,정현석,한화,53,2,0,2,0.0,0,0
2014,조인성,한화,75,0,0,0,-,2,2
2014,조정원,한화,20,0,0,0,-,0,0
2014,최영환,한화,1,0,0,0,-,0,0
2014,추승우,한화,9,0,0,0,-,0,0
2015,박해민,삼성,144,68,60,8,88.2,6,2
2015,박민우,NC,141,62,46,16,74.2,3,5
2015,이대형,KT,140,58,44,14,75.9,6,1
2015,김종호,NC,133,51,41,10,80.4,4,1
2015,테임즈,NC,142,48,40,8,83.3,10,1
2015,오재원,두산,120,39,31,8,79.5,3,2
2015,이용규,한화,124,38,28,10,73.7,8,2
2015,김상수,삼성,132,31,26,5,83.9,2,0
2015,오지환,LG,138,35,25,10,71.4,7,1
2015,아두치,롯데,132,34,24,10,70.6,5,0
2015,나성범,NC,144,27,23,4,85.2,4,1
2015,나바로,삼성,140,28,22,6,78.6,2,0
2015,고종욱,넥센,119,36,22,14,61.1,9,2
2015,김하성,넥센,140,26,22,4,84.6,9,2
2015,이명기,SK,137,32,22,10,68.8,6,3
2015,정근우,한화,126,27,21,6,77.8,7,3
2015,신종길,KIA,99,24,19,5,79.2,1,1
2015,조동화,SK,119,21,18,3,85.7,1,1
2015,구자욱,삼성,116,24,17,7,70.8,5,1
2015,이종욱,NC,125,21,17,4,81.0,3,0
2015,정훈,롯데,135,22,16,6,72.7,6,0
2015,정수빈,두산,128,24,15,9,62.5,5,0
2015,오승택,롯데,122,19,15,4,78.9,3,1
2015,김사연,KT,72,20,15,5,75.0,4,2
2015,최재원,NC,114,19,14,5,73.7,1,1
2015,필,KIA,143,24,14,10,58.3,6,1
2015,박찬도,삼성,116,19,13,6,68.4,1,0
2015,김민혁,KT,82,19,12,7,63.2,1,1
2015,이택근,넥센,105,17,11,6,64.7,10,2
2015,김용의,LG,71,17,11,6,64.7,2,1
2015,박용택,LG,128,15,11,4,73.3,2,1
2015,김현수,두산,141,16,11,5,68.8,7,0
2015,손아섭,롯데,116,17,11,6,64.7,7,1
2015,황재균,롯데,144,21,11,10,52.4,3,4
2015,김호령,KIA,103,13,11,2,84.6,0,2
2015,박병호,넥센,140,13,10,3,76.9,2,1
2015,유재신,넥센,62,11,10,1,90.9,0,2
2015,박계현,SK,97,18,10,8,55.6,2,1
2015,최용규,KIA,69,16,10,6,62.5,4,2
2015,하준호,KT,80,13,10,3,76.9,3,0
2015,서건창,넥센,85,11,9,2,81.8,4,2
2015,문선재,LG,103,15,9,6,60.0,3,0
2015,정성훈,LG,117,13,9,4,69.2,4,0
2015,강한울,KIA,90,13,9,4,69.2,3,2
2015,히메네스,LG,70,10,8,2,80.0,2,1
2015,허경민,두산,117,11,8,3,72.7,2,0
2015,홍성흔,두산,93,9,8,1,88.9,2,0
2015,김문호,롯데,93,13,8,5,61.5,2,0
2015,김민우,KIA,90,11,8,3,72.7,1,0
2015,김원섭,KIA,110,13,8,5,61.5,7,1
2015,김주찬,KIA,98,10,8,2,80.0,3,0
2015,김강민,SK,96,11,7,4,63.6,2,1
2015,김재현,SK,46,8,7,1,87.5,1,0
2015,김재호,두산,133,9,7,2,77.8,4,0
2015,민병헌,두산,129,10,7,3,70.0,4,2
2015,고영우,KIA,82,10,7,3,70.0,2,1
2015,박한이,삼성,94,12,6,6,50.0,5,0
2015,양석환,LG,125,12,6,6,50.0,3,1
2015,정진호,두산,77,9,6,3,66.7,1,0
2015,송주호,한화,121,7,6,1,85.7,5,1
2015,박경수,KT,137,10,6,4,60.0,6,2
2015,모창민,NC,103,5,5,0,100.0,3,0
2015,박지규,LG,102,8,5,3,62.5,2,0
2015,서상우,LG,58,6,5,1,83.3,2,1
2015,브라운,SK,137,7,5,2,71.4,8,0
2015,정의윤,SK,91,5,5,0,100.0,5,0
2015,최정,SK,81,7,5,2,71.4,1,0
2015,양의지,두산,132,9,5,4,55.6,11,0
2015,장운호,한화,42,7,5,2,71.4,1,1
2015,박용근,KT,27,7,5,2,71.4,2,0
2015,심우준,KT,106,7,5,2,71.4,2,0
2015,스나이더,넥센,113,6,4,2,66.7,6,0
2015,지석훈,NC,137,5,4,1,80.0,6,1
2015,박재상,SK,108,9,4,5,44.4,5,1
2015,고영민,두산,41,6,4,2,66.7,1,0
2015,김재환,두산,48,5,4,1,80.0,1,0
2015,김민하,롯데,54,6,4,2,66.7,1,0
2015,문규현,롯데,105,6,4,2,66.7,2,0
2015,강경학,한화,120,7,4,3,57.1,7,0
2015,김상현,KT,134,9,4,5,44.4,4,1
2015,김진곤,KT,67,6,4,2,66.7,0,1
2015,박석민,삼성,135,3,3,0,100.0,10,1
2015,유한준,넥센,139,6,3,3,50.0,10,0
2015,윤석민,넥센,108,5,3,2,60.0,6,0
2015,김성욱,NC,125,6,3,3,50.0,2,1
2015,손시헌,NC,140,5,3,2,60.0,4,1
2015,조영훈,NC,103,3,3,0,100.0,0,0
2015,손주인,LG,98,7,3,4,42.9,2,1
2015,임훈,LG,88,5,3,2,60.0,4,0
2015,채은성,LG,90,6,3,3,50.0,2,0
2015,최경철,LG,109,4,3,1,75.0,5,0
2015,나주환,SK,96,8,3,5,37.5,3,0
2015,박정권,SK,124,6,3,3,50.0,5,1
2015,유서준,SK,17,4,3,1,75.0,0,0
2015,김대우,롯데,39,4,3,1,75.0,2,1
2015,나지완,KIA,116,4,3,1,75.0,4,0
2015,박찬호,KIA,69,4,3,1,75.0,4,0
2015,백용환,KIA,65,4,3,1,75.0,1,0
2015,이범호,KIA,138,7,3,4,42.9,6,0
2015,이호신,KIA,54,3,3,0,100.0,1,0
2015,권용관,한화,116,9,3,6,33.3,6,0
2015,김태균,한화,133,4,3,1,75.0,3,0
2015,박기혁,KT,126,3,3,0,100.0,9,0
2015,배병옥,KT,66,3,3,0,100.0,0,0
2015,오정복,KT,66,6,3,3,50.0,1,1
2015,이승엽,삼성,122,3,2,1,66.7,4,0
2015,이흥련,삼성,71,3,2,1,66.7,1,1
2015,최선호,삼성,33,2,2,0,100.0,1,0
2015,최형우,삼성,144,7,2,5,28.6,11,0
2015,김지수,넥센,104,3,2,1,66.7,0,0
2015,임병욱,넥센,40,6,2,4,33.3,1,1
2015,김준완,NC,30,3,2,1,66.7,0,1
2015,용덕한,NC,91,3,2,1,66.7,1,0
2015,유강남,LG,126,3,2,1,66.7,2,0
2015,이병규,LG,70,3,2,1,66.7,0,0
2015,이진영,LG,103,6,2,4,33.3,2,0
2015,황목치승,LG,24,2,2,0,100.0,0,0
2015,로메로,두산,76,2,2,0,100.0,6,1
2015,박건우,두산,70,3,2,1,66.7,2,0
2015,안중열,롯데,80,2,2,0,100.0,1,0
2015,이우민,롯데,75,2,2,0,100.0,1,0
2015,임재철,롯데,38,3,2,1,66.7,1,0
2015,박준태,KIA,51,3,2,1,66.7,1,0
2015,김회성,한화,83,6,2,4,33.3,4,0
2015,주현상,한화,103,2,2,0,100.0,4,2
2015,이지찬,KT,34,2,2,0,100.0,0,0
2015,배영섭,삼성,4,1,1,0,100.0,0,0
2015,이지영,삼성,124,3,1,2,33.3,4,0
2015,김민성,넥센,118,2,1,1,50.0,3,1
2015,문우람,넥센,63,2,1,1,50.0,0,0
2015,김태군,NC,144,2,1,1,50.0,3,1
2015,강병의,LG,8,3,1,2,33.3,0,0
2015,안익훈,LG,50,2,1,1,50.0,3,0
2015,윤진호,LG,30,1,1,0,100.0,2,0
2015,김성현,SK,129,5,1,4,20.0,5,2
2015,이재원,SK,140,4,1,3,25.0,5,1
2015,정상호,SK,113,3,1,2,33.3,5,1
2015,유민상,두산,15,1,1,0,100.0,1,0
2015,김재유,롯데,18,1,1,0,100.0,2,0
2015,김주현,롯데,47,1,1,0,100.0,0,0
2015,오현근,롯데,20,2,1,1,50.0,0,1
2015,김다원,KIA,108,1,1,0,100.0,4,2
2015,박기남,KIA,51,2,1,1,50.0,1,0
2015,오준혁,KIA,32,2,1,1,50.0,0,0
2015,이홍구,KIA,112,1,1,0,100.0,2,0
2015,김경언,한화,107,4,1,3,25.0,3,0
2015,모건,한화,10,2,1,1,50.0,1,0
2015,이성열,한화,101,2,1,1,50.0,0,1
2015,이시찬,한화,34,2,1,1,50.0,0,0
2015,정범모,한화,51,3,1,2,33.3,0,1
2015,황선일,한화,13,1,1,0,100,1,0
2015,김동명,KT,21,2,1,1,50.0,2,0
2015,김선민,KT,23,1,1,0,100,0,0
2015,김영환,KT,37,1,1,0,100,1,0
2015,송민섭,KT,28,1,1,0,100,2,0
2015,신명철,KT,89,1,1,0,100,4,0
2015,장성우,KT,133,3,1,2,33.3,5,1
2015,장성호,KT,49,1,1,0,100,1,0
2015,강봉규,삼성,5,0,0,0,-,0,0
2015,김재현,삼성,73,0,0,0,-,0,0
2015,김정혁,삼성,17,0,0,0,-,0,0
2015,김태완,삼성,4,0,0,0,-,0,0
2015,박계범,삼성,3,0,0,0,-,0,0
2015,백상원,삼성,52,0,0,0,-,0,1
2015,심창민,삼성,1,0,0,0,-,0,0
2015,우동균,삼성,37,2,0,2,0.0,1,0
2015,윤영수,삼성,4,0,0,0,-,0,0
2015,이상훈,삼성,4,0,0,0,-,0,0
2015,이영욱,삼성,38,1,0,1,0.0,0,0
2015,이정식,삼성,5,0,0,0,-,0,0
2015,임창용,삼성,2,0,0,0,-,0,0
2015,정인욱,삼성,1,0,0,0,-,0,0
2015,진갑용,삼성,39,0,0,0,-,2,0
2015,채태인,삼성,104,2,0,2,0.0,5,0
2015,최민구,삼성,6,0,0,0,-,0,0
2015,강지광,넥센,13,0,0,0,-,0,0
2015,김민준,넥센,2,0,0,0,-,0,0
2015,김재현,넥센,59,0,0,0,-,1,1
2015,김택형,넥센,1,0,0,0,-,0,0
2015,마정길,넥센,1,0,0,0,-,0,0
2015,문성현,넥센,2,0,0,0,-,0,0
2015,박동원,넥센,127,0,0,0,-,5,0
2015,박헌도,넥센,108,2,0,2,0.0,5,0
2015,서동욱,넥센,55,0,0,0,-,0,1
2015,손승락,넥센,1,0,0,0,-,0,0
2015,송성문,넥센,7,0,0,0,-,0,0
2015,유선정,넥센,17,0,0,0,-,1,0
2015,장시윤,넥센,17,1,0,1,0.0,0,0
2015,장영석,넥센,6,0,0,0,-,0,0
2015,한현희,넥센,2,0,0,0,-,0,0
2015,허정협,넥센,4,0,0,0,-,0,0
2015,홍성갑,넥센,7,0,0,0,-,0,1
2015,강구성,NC,4,0,0,0,-,0,0
2015,강민국,NC,1,0,0,0,-,0,0
2015,강장산,NC,2,0,0,0,-,0,0
2015,고창성,NC,1,0,0,0,-,0,0
2015,김태진,NC,1,0,0,0,-,0,0
2015,노성호,NC,1,0,0,0,-,0,0
2015,노진혁,NC,65,0,0,0,-,0,0
2015,마낙길,NC,1,1,0,1,0.0,0,0
2015,민성기,NC,3,0,0,0,-,0,0
2015,박광열,NC,33,1,0,1,0.0,1,0
2015,박정준,NC,19,0,0,0,-,0,0
2015,손민한,NC,1,0,0,0,-,0,0
2015,윤병호,NC,9,0,0,0,-,0,0
2015,이민호,NC,1,0,0,0,-,0,0
2015,이창섭,NC,16,0,0,0,-,0,0
2015,이태양,NC,1,0,0,0,-,0,0
2015,이혜천,NC,3,0,0,0,-,0,0
2015,이호준,NC,131,2,0,2,0.0,5,0
2015,임정호,NC,1,0,0,0,-,0,0
2015,임창민,NC,2,0,0,0,-,0,0
2015,조평호,NC,22,0,0,0,-,0,0
2015,최금강,NC,1,0,0,0,-,0,0
2015,황윤호,NC,10,0,0,0,-,0,0
2015,김영관,LG,20,0,0,0,-,0,0
2015,김재성,LG,9,0,0,0,-,1,0
2015,김재율,LG,1,0,0,0,-,0,0
2015,김지용,LG,3,0,0,0,-,0,0
2015,나성용,LG,40,0,0,0,-,1,0
2015,박성준,LG,11,0,0,0,-,1,0
2015,백창수,LG,25,0,0,0,-,0,1
2015,봉중근,LG,6,0,0,0,-,0,0
2015,신승현,LG,1,0,0,0,-,0,0
2015,양원혁,LG,3,0,0,0,-,0,0
2015,유원상,LG,1,0,0,0,-,0,0
2015,이동현,LG,4,0,0,0,-,0,0
2015,이민재,LG,28,1,0,1,0.0,1,1
2015,이병규,LG,54,0,0,0,-,0,0
2015,이준형,LG,1,0,0,0,-,0,0
2015,장준원,LG,20,0,0,0,-,1,0
2015,조윤준,LG,7,0,0,0,-,0,0
2015,진해수,LG,1,0,0,0,-,0,0
2015,최동환,LG,1,0,0,0,-,0,0
2015,최승준,LG,8,0,0,0,-,0,0
2015,한나한,LG,32,0,0,0,-,1,0
2015,고효준,SK,1,0,0,0,-,0,0
2015,김기현,SK,9,0,0,0,-,0,0
2015,김민식,SK,23,0,0,0,-,0,1
2015,김연훈,SK,49,1,0,1,0.0,2,0
2015,박윤,SK,17,0,0,0,-,0,0
2015,박정배,SK,1,0,0,0,-,0,0
2015,박진만,SK,78,2,0,2,0.0,3,0
2015,박철우,SK,19,0,0,0,-,0,0
2015,서진용,SK,1,0,0,0,-,0,0
2015,신재웅,SK,2,0,0,0,-,0,0
2015,안정광,SK,10,0,0,0,-,0,0
2015,윤길현,SK,1,0,0,0,-,0,0
2015,윤중환,SK,15,1,0,1,0.0,0,0
2015,이대수,SK,36,1,0,1,0.0,0,0
2015,이재영,SK,1,0,0,0,-,0,0
2015,이진석,SK,6,1,0,1,0.0,0,0
2015,이창욱,SK,1,0,0,0,-,0,0
2015,이한진,SK,1,0,0,0,-,0,0
2015,이현석,SK,3,0,0,0,-,0,0
2015,정우람,SK,5,0,0,0,-,0,0
2015,채병용,SK,1,0,0,0,-,0,0
2015,최정민,SK,8,0,0,0,-,0,1
2015,허웅,SK,18,0,0,0,-,0,0
2015,홍명찬,SK,5,0,0,0,-,0,0
2015,국해성,두산,11,0,0,0,-,0,0
2015,김응민,두산,4,0,0,0,-,0,0
2015,김진형,두산,14,0,0,0,-,0,0
2015,노경은,두산,1,0,0,0,-,0,0
2015,니퍼트,두산,1,0,0,0,-,0,0
2015,루츠,두산,8,0,0,0,-,0,0
2015,류지혁,두산,14,0,0,0,-,0,0
2015,양종민,두산,32,1,0,1,0.0,1,0
2015,양현,두산,1,0,0,0,-,0,0
2015,오재일,두산,66,0,0,0,-,0,0
2015,이원재,두산,1,0,0,0,-,0,0
2015,이현승,두산,2,0,0,0,-,0,0
2015,장민석,두산,53,1,0,1,0.0,1,0
2015,진야곱,두산,2,0,0,0,-,0,0
2015,최영진,두산,1,0,0,0,-,0,0
2015,최재훈,두산,71,0,0,0,-,1,0
2015,최주환,두산,100,3,0,3,0.0,3,1
2015,함덕주,두산,2,0,0,0,-,0,0
2015,강동수,롯데,22,0,0,0,-,0,0
2015,강민호,롯데,123,0,0,0,-,5,0
2015,김대륙,롯데,71,1,0,1,0.0,2,0
2015,김준태,롯데,27,0,0,0,-,0,0
2015,박세웅,롯데,1,0,0,0,-,1,0
2015,박종윤,롯데,98,1,0,1,0.0,4,0
2015,박준서,롯데,3,0,0,0,-,0,0
2015,박진형,롯데,1,0,0,0,-,0,0
2015,배장호,롯데,1,0,0,0,-,0,0
2015,백민기,롯데,8,0,0,0,-,0,0
2015,손용석,롯데,38,0,0,0,-,3,0
2015,심수창,롯데,2,0,0,0,-,0,0
2015,오윤석,롯데,29,0,0,0,-,0,0
2015,이성민,롯데,3,0,0,0,-,0,0
2015,이여상,롯데,6,0,0,0,-,0,0
2015,이정민,롯데,3,0,0,0,-,0,0
2015,조홍석,롯데,3,0,0,0,-,1,0
2015,최준석,롯데,144,0,0,0,-,3,1
2015,홍성민,롯데,2,0,0,0,-,0,0
2015,황동채,롯데,2,0,0,0,-,0,0
2015,황진수,롯데,2,0,0,0,-,1,0
2015,김광수,KIA,2,0,0,0,-,0,0
2015,김병현,KIA,1,0,0,0,-,0,0
2015,김주형,KIA,45,0,0,0,-,0,0
2015,김준,KIA,1,0,0,0,-,0,0
2015,김태영,KIA,3,0,0,0,-,0,0
2015,노수광,KIA,10,0,0,0,-,0,0
2015,문경찬,KIA,2,0,0,0,-,0,0
2015,박정수,KIA,4,0,0,0,-,0,0
2015,박준표,KIA,1,0,0,0,-,0,0
2015,스틴슨,KIA,1,0,0,0,-,0,0
2015,심동섭,KIA,4,0,0,0,-,0,0
2015,에반,KIA,1,0,0,0,-,0,0
2015,윤석민,KIA,4,0,0,0,-,0,0
2015,윤완주,KIA,28,0,0,0,-,1,0
2015,이성우,KIA,79,0,0,0,-,1,0
2015,이은총,KIA,11,0,0,0,-,1,1
2015,이인행,KIA,20,0,0,0,-,1,0
2015,전현태,KIA,2,0,0,0,-,0,0
2015,차일목,KIA,11,0,0,0,-,0,0
2015,최병연,KIA,19,0,0,0,-,0,0
2015,최영필,KIA,3,0,0,0,-,0,0
2015,최희섭,KIA,42,0,0,0,-,4,0
2015,한기주,KIA,1,0,0,0,-,0,0
2015,한승혁,KIA,6,0,0,0,-,0,0
2015,험버,KIA,1,0,0,0,-,0,0
2015,홍건희,KIA,1,0,0,0,-,0,0
2015,황대인,KIA,22,0,0,0,-,1,0
2015,황수현,KIA,2,0,0,0,-,0,0
2015,고동진,한화,27,0,0,0,-,0,0
2015,권혁,한화,9,0,0,0,-,0,0
2015,김기현,한화,1,0,0,0,-,0,0
2015,김민우,한화,1,0,0,0,-,0,0
2015,김태완,한화,22,0,0,0,-,0,0
2015,박노민,한화,23,0,0,0,-,0,0
2015,박성호,한화,1,0,0,0,-,0,0
2015,박정진,한화,2,0,0,0,-,0,0
2015,박한길,한화,1,0,0,0,-,0,0
2015,송광민,한화,12,0,0,0,-,0,0
2015,신성현,한화,64,0,0,0,-,1,0
2015,윤규진,한화,2,0,0,0,-,0,0
2015,이종환,한화,44,0,0,0,-,0,1
2015,이창열,한화,5,0,0,0,-,0,0
2015,임익준,한화,4,0,0,0,-,0,0
2015,정대훈,한화,3,0,0,0,-,0,0
2015,정현석,한화,43,0,0,0,-,2,1
2015,조인성,한화,106,0,0,0,-,1,0
2015,조정원,한화,2,0,0,0,-,0,0
2015,지성준,한화,9,0,0,0,-,0,0
2015,채기영,한화,3,0,0,0,-,0,0
2015,최진행,한화,109,3,0,3,0.0,2,1
2015,탈보트,한화,1,0,0,0,-,0,0
2015,폭스,한화,38,0,0,0,-,1,0
2015,하주석,한화,4,0,0,0,-,0,0
2015,한상훈,한화,35,3,0,3,0.0,0,0
2015,허도환,한화,61,0,0,0,-,0,0
2015,고영표,KT,1,0,0,0,-,0,0
2015,김기표,KT,2,0,0,0,-,0,0
2015,김민수,KT,2,0,0,0,-,0,0
2015,김사율,KT,1,0,0,0,-,0,0
2015,김종민,KT,26,1,0,1,0.0,0,0
2015,김태훈,KT,22,0,0,0,-,0,0
2015,댄블랙,KT,54,0,0,0,-,2,0
2015,마르테,KT,115,0,0,0,-,2,0
2015,모상기,KT,8,0,0,0,-,0,0
2015,문상철,KT,51,0,0,0,-,1,0
2015,배우열,KT,1,0,0,0,-,0,0
2015,심재민,KT,1,0,0,0,-,0,0
2015,안상빈,KT,1,0,0,0,-,0,0
2015,윤도경,KT,4,0,0,0,-,0,0
2015,윤여운,KT,2,0,0,0,-,0,0
2015,윤요섭,KT,74,1,0,1,0.0,0,0
2015,이창진,KT,13,0,0,0,-,0,0
2015,이해창,KT,5,0,0,0,-,0,0
2015,장시환,KT,3,0,0,0,-,0,0
2015,정대현,KT,1,0,0,0,-,0,0
2015,조무근,KT,1,0,0,0,-,0,0
2015,조중근,KT,25,0,0,0,-,0,0
2015,홍성무,KT,3,0,0,0,-,0,0
2015,홍성용,KT,1,0,0,0,-,0,0
2015,황덕균,KT,1,0,0,0,-,0,0
2016,박해민,삼성,141,67,52,15,77.6,6,2
2016,손아섭,롯데,144,46,42,4,91.3,10,1
2016,이대형,KT,143,57,37,20,64.9,2,2
2016,고종욱,넥센,133,42,28,14,66.7,9,2
2016,김하성,넥센,144,43,28,15,65.1,4,0
2016,서건창,넥센,140,39,26,13,66.7,9,1
2016,황재균,롯데,127,35,25,10,71.4,5,2
2016,정근우,한화,138,28,22,6,78.6,8,2
2016,이용규,한화,113,32,21,11,65.6,2,1
2016,박민우,NC,121,26,20,6,76.9,1,0
2016,김호령,KIA,124,29,19,10,65.5,8,2
2016,김용의,LG,105,26,19,7,73.1,4,1
2016,히메네스,LG,135,27,18,9,66.7,9,2
2016,박건우,두산,132,23,17,6,73.9,8,1
2016,임병욱,넥센,104,23,17,6,73.9,3,2
2016,오지환,LG,121,26,17,9,65.4,4,2
2016,심우준,KT,122,18,17,1,94.4,2,1
2016,박정음,넥센,98,25,16,9,64.0,4,1
2016,유재신,넥센,93,23,16,7,69.6,0,0
2016,고메즈,SK,117,24,16,8,66.7,6,0
2016,이종욱,NC,134,18,15,3,83.3,4,0
2016,아두치,롯데,64,17,15,2,88.2,3,0
2016,이명기,SK,99,22,14,8,63.6,5,0
2016,오재원,두산,122,23,13,10,56.5,3,1
2016,김종호,NC,93,19,13,6,68.4,5,0
2016,테임즈,NC,123,17,13,4,76.5,4,1
2016,김재현,SK,100,20,13,7,65.0,2,0
2016,정수빈,두산,114,16,12,4,75.0,5,0
2016,김강민,SK,115,17,12,5,70.6,8,0
2016,노수광,KIA,77,14,12,2,85.7,0,2
2016,김문호,롯데,140,27,12,15,44.4,4,2
2016,하준호,KT,94,16,12,4,75.0,2,2
2016,구자욱,삼성,108,15,10,5,66.7,6,0
2016,필,KIA,132,13,10,3,76.9,4,2
2016,민병헌,두산,134,11,9,2,81.8,7,0
2016,김주찬,KIA,130,16,9,7,56.3,5,0
2016,서동욱,KIA,124,13,9,4,69.2,5,0
2016,김재호,두산,137,12,8,4,66.7,6,0
2016,김재환,두산,134,10,8,2,80.0,4,0
2016,백상원,삼성,132,11,8,3,72.7,4,0
2016,이재율,NC,32,9,8,1,88.9,0,0
2016,최정민,SK,88,12,8,4,66.7,2,1
2016,이병규,LG,103,13,8,5,61.5,4,1
2016,임훈,LG,60,12,8,4,66.7,0,0
2016,정성훈,LG,126,12,8,4,66.7,2,0
2016,나성범,NC,144,11,7,4,63.6,4,1
2016,이택근,넥센,127,11,7,4,63.6,4,1
2016,강한울,KIA,104,10,7,3,70.0,3,0
2016,신종길,KIA,75,11,7,4,63.6,2,0
2016,정훈,롯데,121,14,7,7,50.0,3,1
2016,채은성,LG,128,10,7,3,70.0,5,0
2016,허경민,두산,144,12,6,6,50.0,5,1
2016,김상수,삼성,105,10,6,4,60.0,1,1
2016,이영욱,삼성,104,9,6,3,66.7,0,0
2016,김민성,넥센,141,9,6,3,66.7,6,0
2016,조동화,SK,76,8,6,2,75.0,3,0
2016,나지완,KIA,118,9,6,3,66.7,4,0
2016,윤정우,KIA,46,7,6,1,85.7,1,2
2016,오승택,롯데,42,8,6,2,75.0,1,0
2016,박용택,LG,138,12,6,6,50.0,6,0
2016,이천웅,LG,103,15,6,9,40.0,1,1
2016,배영섭,삼성,93,13,5,8,38.5,4,2
2016,이승엽,삼성,142,7,5,2,71.4,3,0
2016,김성욱,NC,130,7,5,2,71.4,3,0
2016,양성우,한화,108,7,5,2,71.4,9,1
2016,하주석,한화,115,12,5,7,41.7,6,1
2016,김동한,롯데,78,6,5,1,83.3,5,0
2016,문선재,LG,52,5,5,0,100.0,3,1
2016,손주인,LG,122,9,5,4,55.6,10,1
2016,정주현,LG,99,10,5,5,50.0,5,1
2016,전민수,KT,74,7,5,2,71.4,2,2
2016,박정권,SK,125,4,4,0,100.0,2,0
2016,강민호,롯데,116,4,4,0,100.0,6,0
2016,김민하,롯데,46,4,4,0,100.0,0,0
2016,유한준,KT,110,5,4,1,80.0,3,0
2016,류지혁,두산,90,5,3,2,60.0,0,0
2016,이지영,삼성,129,5,3,2,60.0,7,0
2016,최재원,삼성,28,4,3,1,75.0,1,0
2016,모창민,NC,63,5,3,2,60.0,1,0
2016,이상호,NC,15,3,3,0,100.0,0,0
2016,이호준,NC,119,5,3,2,60.0,7,0
2016,조영훈,NC,109,6,3,3,50.0,0,0
2016,박동원,넥센,127,4,3,1,75.0,5,0
2016,김성현,SK,138,6,3,3,50.0,6,0
2016,박재상,SK,94,9,3,6,33.3,4,0
2016,김경언,한화,66,3,3,0,100.0,2,0
2016,송광민,한화,116,3,3,0,100.0,5,0
2016,장민석,한화,98,6,3,3,50.0,3,2
2016,고영우,KIA,63,5,3,2,60.0,0,1
2016,김상호,롯데,114,4,3,1,75.0,4,1
2016,나경민,롯데,35,6,3,3,50.0,0,0
2016,박종윤,롯데,73,5,3,2,60.0,1,0
2016,전준우,롯데,25,6,3,3,50.0,1,0
2016,양석환,LG,80,3,3,0,100.0,3,0
2016,김선민,KT,32,4,3,1,75.0,0,0
2016,박경수,KT,121,4,3,1,75.0,6,1
2016,박세혁,두산,87,4,2,2,50.0,1,0
2016,양의지,두산,108,2,2,0,100.0,8,0
2016,조수행,두산,66,5,2,3,40.0,2,0
2016,최형우,삼성,138,4,2,2,50.0,6,0
2016,김준완,NC,122,7,2,5,28.6,2,0
2016,박석민,NC,126,2,2,0,100.0,3,0
2016,김지수,넥센,81,4,2,2,50.0,1,1
2016,윤석민,넥센,92,5,2,3,40.0,2,0
2016,김동엽,SK,57,3,2,1,66.7,3,1
2016,박승욱,SK,36,3,2,1,66.7,2,0
2016,정의윤,SK,144,5,2,3,40.0,12,0
2016,박찬호,KIA,69,2,2,0,100.0,1,0
2016,백용환,KIA,80,3,2,1,66.7,1,0
2016,김재유,롯데,21,5,2,3,40.0,0,0
2016,맥스웰,롯데,23,4,2,2,50.0,1,0
2016,문규현,롯데,120,5,2,3,40.0,1,1
2016,오현근,롯데,19,2,2,0,100.0,1,0
2016,이여상,롯데,61,4,2,2,50.0,1,0
2016,이우민,롯데,52,4,2,2,50.0,0,1
2016,황목치승,LG,48,4,2,2,50.0,1,0
2016,김민혁,KT,26,3,2,1,66.7,0,0
2016,김연훈,KT,103,2,2,0,100.0,1,0
2016,배병옥,KT,65,3,2,1,66.7,1,1
2016,이진영,KT,115,7,2,5,28.6,7,1
2016,국해성,두산,58,2,1,1,50.0,1,0
2016,오재일,두산,105,1,1,0,100.0,5,0
2016,김재현,삼성,122,2,1,1,50.0,2,0
2016,김정혁,삼성,46,2,1,1,50.0,1,0
2016,박한이,삼성,110,1,1,0,100.0,2,0
2016,최선호,삼성,60,3,1,2,33.3,1,0
2016,손시헌,NC,110,1,1,0,100.0,5,0
2016,황윤호,NC,33,1,1,0,100.0,1,0
2016,강지광,넥센,40,4,1,3,25.0,0,1
2016,대니돈,넥센,129,1,1,0,100.0,3,0
2016,홍성갑,넥센,44,1,1,0,100.0,0,0
2016,김민식,SK,88,2,1,1,50.0,2,1
2016,이재원,SK,130,6,1,5,16.7,8,1
2016,최정,SK,141,3,1,2,33.3,1,1
2016,한동민,SK,6,1,1,0,100.0,0,0
2016,김태균,한화,144,1,1,0,100.0,7,0
2016,로사리오,한화,127,4,1,3,25.0,6,1
2016,김민우,KIA,19,1,1,0,100.0,0,0
2016,김선빈,KIA,6,2,1,1,50.0,0,0
2016,김원섭,KIA,37,1,1,0,100.0,1,0
2016,김주형,KIA,135,3,1,2,33.3,5,2
2016,오준혁,KIA,47,3,1,2,33.3,2,0
2016,이범호,KIA,138,2,1,1,50.0,5,0
2016,이진영,KIA,17,2,1,1,50.0,0,0
2016,이호신,KIA,51,2,1,1,50.0,2,0
2016,최원준,KIA,14,2,1,1,50.0,0,0
2016,김주현,롯데,21,1,1,0,100.0,0,0
2016,박헌도,롯데,37,1,1,0,100.0,0,0
2016,서상우,LG,56,1,1,0,100.0,1,0
2016,안익훈,LG,68,2,1,1,50.0,1,0
2016,윤진호,LG,34,1,1,0,100,0,0
2016,이형종,LG,61,1,1,0,100,5,2
2016,김사연,KT,20,3,1,2,33.3,0,0
2016,남태혁,KT,16,1,1,0,100,0,0
2016,문상철,KT,48,1,1,0,100,2,0
2016,오정복,KT,96,1,1,0,100,8,0
2016,유민상,KT,95,2,1,1,50.0,4,0
2016,윤요섭,KT,66,2,1,1,50.0,0,0
2016,이해창,KT,88,2,1,1,50.0,5,0
2016,강동연,두산,3,0,0,0,-,0,0
2016,고봉재,두산,1,0,0,0,-,0,0
2016,고영민,두산,8,0,0,0,-,0,0
2016,김성배,두산,1,0,0,0,-,0,0
2016,김인태,두산,14,0,0,0,-,0,0
2016,서예일,두산,31,0,0,0,-,0,0
2016,에반스,두산,118,0,0,0,-,6,0
2016,이우성,두산,2,0,0,0,-,0,0
2016,이원석,두산,7,0,0,0,-,0,0
2016,이현승,두산,2,0,0,0,-,0,0
2016,이현호,두산,4,0,0,0,-,0,0
2016,정진철,두산,2,0,0,0,-,0,0
2016,정진호,두산,31,2,0,2,0.0,0,0
2016,진야곱,두산,1,0,0,0,-,0,0
2016,최용제,두산,4,0,0,0,-,0,1
2016,최재훈,두산,22,0,0,0,-,1,0
2016,최주환,두산,85,0,0,0,-,1,0
2016,함덕주,두산,1,0,0,0,-,0,0
2016,홍성흔,두산,17,1,0,1,0.0,1,0
2016,권정웅,삼성,3,0,0,0,-,0,0
2016,김태완,삼성,34,0,0,0,-,0,0
2016,나성용,삼성,6,0,0,0,-,0,0
2016,박계범,삼성,5,0,0,0,-,0,0
2016,발디리스,삼성,44,0,0,0,-,3,0
2016,성의준,삼성,24,0,0,0,-,0,0
2016,심창민,삼성,1,0,0,0,-,0,0
2016,안지만,삼성,1,0,0,0,-,0,0
2016,우동균,삼성,33,0,0,0,-,0,0
2016,이상훈,삼성,8,0,0,0,-,0,0
2016,이성규,삼성,6,0,0,0,-,0,0
2016,이정식,삼성,7,0,0,0,-,0,0
2016,이흥련,삼성,85,0,0,0,-,1,0
2016,임대한,삼성,1,0,0,0,-,0,0
2016,장필준,삼성,1,0,0,0,-,0,0
2016,조동찬,삼성,90,1,0,1,0.0,3,0
2016,황선도,삼성,1,0,0,0,-,0,0
2016,강구성,NC,2,0,0,0,-,0,0
2016,강민국,NC,24,0,0,0,-,0,0
2016,구창모,NC,1,0,0,0,-,0,0
2016,권희동,NC,14,1,0,1,0.0,2,0
2016,김선규,NC,1,0,0,0,-,0,0
2016,김진성,NC,3,0,0,0,-,0,0
2016,김태군,NC,134,0,0,0,-,3,0
2016,김태진,NC,2,0,0,0,-,0,0
2016,김학성,NC,1,0,0,0,-,0,0
2016,도태훈,NC,6,0,0,0,-,0,0
2016,민성기,NC,1,0,0,0,-,0,0
2016,박광열,NC,13,0,0,0,-,0,0
2016,박민석,NC,1,0,0,0,-,0,0
2016,박세웅,NC,1,0,0,0,-,0,0
2016,박준영,NC,3,0,0,0,-,0,0
2016,배재환,NC,2,0,0,0,-,0,0
2016,용덕한,NC,88,0,0,0,-,0,0
2016,원종현,NC,2,0,0,0,-,0,0
2016,윤병호,NC,11,0,0,0,-,0,1
2016,이민호,NC,3,0,0,0,-,0,0
2016,이재학,NC,1,0,0,0,-,0,0
2016,임정호,NC,1,0,0,0,-,0,0
2016,임창민,NC,6,0,0,0,-,0,0
2016,장현식,NC,1,0,0,0,-,0,0
2016,조평호,NC,3,0,0,0,-,0,0
2016,지석훈,NC,141,2,0,2,0.0,3,0
2016,최금강,NC,1,0,0,0,-,0,0
2016,김민준,넥센,20,1,0,1,0.0,0,0
2016,김세현,넥센,2,0,0,0,-,0,0
2016,김웅빈,넥센,10,0,0,0,-,0,0
2016,김재현,넥센,56,0,0,0,-,0,0
2016,김택형,넥센,1,0,0,0,-,0,0
2016,마정길,넥센,1,0,0,0,-,0,0
2016,박윤,넥센,7,0,0,0,-,0,0
2016,오주원,넥센,1,0,0,0,-,0,0
2016,이정훈,넥센,1,0,0,0,-,0,0
2016,장시윤,넥센,9,0,0,0,-,0,0
2016,장영석,넥센,23,1,0,1,0.0,1,1
2016,주효상,넥센,12,0,0,0,-,1,0
2016,지재옥,넥센,7,0,0,0,-,1,0
2016,채태인,넥센,124,1,0,1,0.0,3,1
2016,허정협,넥센,13,0,0,0,-,0,0
2016,김기현,SK,14,0,0,0,-,0,0
2016,김승회,SK,1,0,0,0,-,0,0
2016,김주한,SK,3,0,0,0,-,0,0
2016,김태훈,SK,1,0,0,0,-,0,0
2016,나주환,SK,24,4,0,4,0.0,0,0
2016,라라,SK,1,0,0,0,-,0,0
2016,문광은,SK,1,0,0,0,-,0,0
2016,박민호,SK,3,0,0,0,-,0,0
2016,박정배,SK,3,0,0,0,-,0,0
2016,박희수,SK,5,0,0,0,-,0,0
2016,신재웅,SK,2,0,0,0,-,0,0
2016,유서준,SK,8,0,0,0,-,1,0
2016,이건욱,SK,1,0,0,0,-,0,0
2016,이대수,SK,14,0,0,0,-,0,0
2016,이정담,SK,1,0,0,0,-,0,0
2016,이진석,SK,41,0,0,0,-,1,1
2016,이현석,SK,11,0,0,0,-,1,0
2016,임석진,SK,11,0,0,0,-,0,0
2016,전유수,SK,3,0,0,0,-,0,0
2016,정영일,SK,2,0,0,0,-,0,0
2016,조성모,SK,3,0,0,0,-,0,0
2016,조한욱,SK,1,0,0,0,-,0,0
2016,채병용,SK,2,0,0,0,-,0,0
2016,최승준,SK,76,0,0,0,-,1,0
2016,최정용,SK,48,0,0,0,-,1,2
2016,강경학,한화,46,0,0,0,-,2,0
2016,권용관,한화,40,0,0,0,-,0,1
2016,권혁,한화,1,0,0,0,-,0,0
2016,김경태,한화,1,0,0,0,-,0,0
2016,김원석,한화,11,0,0,0,-,0,0
2016,김주현,한화,4,0,0,0,-,0,0
2016,김태완,한화,24,0,0,0,-,0,0
2016,김회성,한화,28,0,0,0,-,0,0
2016,로저스,한화,1,0,0,0,-,0,0
2016,박노민,한화,5,0,0,0,-,0,0
2016,박정진,한화,1,0,0,0,-,0,0
2016,박준혁,한화,6,0,0,0,-,0,0
2016,송주호,한화,33,2,0,2,0.0,0,0
2016,송창식,한화,1,0,0,0,-,0,0
2016,신성현,한화,89,4,0,4,0.0,2,0
2016,오선진,한화,57,0,0,0,-,0,0
2016,윤규진,한화,1,0,0,0,-,0,0
2016,이동훈,한화,17,0,0,0,-,0,0
2016,이성열,한화,86,0,0,0,-,2,0
2016,이양기,한화,17,0,0,0,-,0,0
2016,이종환,한화,31,0,0,0,-,0,0
2016,이태양,한화,1,0,0,0,-,0,0
2016,임익준,한화,3,0,0,0,-,0,0
2016,장민재,한화,2,0,0,0,-,0,0
2016,장운호,한화,51,0,0,0,-,0,0
2016,정범모,한화,5,0,0,0,-,0,0
2016,정우람,한화,2,0,0,0,-,0,0
2016,정현석,한화,3,0,0,0,-,0,0
2016,조인성,한화,76,0,0,0,-,0,0
2016,주현상,한화,15,0,0,0,-,0,0
2016,지성준,한화,1,0,0,0,-,0,0
2016,차일목,한화,117,0,0,0,-,4,0
2016,최윤석,한화,11,0,0,0,-,0,0
2016,최진행,한화,28,0,0,0,-,0,0
2016,허도환,한화,48,0,0,0,-,0,1
2016,김광수,KIA,1,0,0,0,-,0,0
2016,김다원,KIA,25,0,0,0,-,0,0
2016,김윤동,KIA,1,0,0,0,-,0,0
2016,김진우,KIA,2,0,0,0,-,0,0
2016,박준표,KIA,1,0,0,0,-,0,0
2016,배힘찬,KIA,1,0,0,0,-,0,0
2016,심동섭,KIA,2,0,0,0,-,0,0
2016,안치홍,KIA,10,0,0,0,-,1,0
2016,윤완주,KIA,34,0,0,0,-,0,0
2016,이성우,KIA,55,0,0,0,-,1,1
2016,이홍구,KIA,106,1,0,1,0.0,1,0
2016,임창용,KIA,2,0,0,0,-,0,0
2016,전상현,KIA,1,0,0,0,-,0,0
2016,정용운,KIA,1,0,0,0,-,0,0
2016,최병연,KIA,12,0,0,0,-,0,0
2016,최영필,KIA,1,0,0,0,-,0,0
2016,한기주,KIA,1,0,0,0,-,0,0
2016,한승택,KIA,27,0,0,0,-,0,0
2016,한승혁,KIA,2,0,0,0,-,0,0
2016,헥터,KIA,3,0,0,0,-,0,0
2016,홍건희,KIA,4,0,0,0,-,0,0
2016,홍재호,KIA,22,0,0,0,-,0,0
2016,황대인,KIA,4,0,0,0,-,0,0
2016,강동관,롯데,2,0,0,0,-,0,0
2016,김대륙,롯데,58,0,0,0,-,0,0
2016,김대우,롯데,2,0,0,0,-,0,0
2016,김사훈,롯데,19,0,0,0,-,1,0
2016,김준태,롯데,68,0,0,0,-,3,1
2016,김지수,롯데,6,0,0,0,-,0,0
2016,레일리,롯데,1,0,0,0,-,0,0
2016,박시영,롯데,2,0,0,0,-,0,0
2016,손승락,롯데,4,0,0,0,-,0,0
2016,손용석,롯데,51,0,0,0,-,0,0
2016,신본기,롯데,25,1,0,1,0.0,0,0
2016,안중열,롯데,19,0,0,0,-,0,0
2016,윤길현,롯데,1,0,0,0,-,0,0
2016,이정민,롯데,1,0,0,0,-,0,0
2016,정대현,롯데,1,0,0,0,-,0,0
2016,최준석,롯데,116,0,0,0,-,4,0
2016,홍성민,롯데,1,0,0,0,-,0,0
2016,황진수,롯데,11,1,0,1,0.0,0,0
2016,강승호,LG,18,0,0,0,-,0,0
2016,김대현,LG,1,0,0,0,-,0,0
2016,김지성,LG,2,0,0,0,-,0,0
2016,박성준,LG,1,0,0,0,-,0,0
2016,박재욱,LG,26,0,0,0,-,1,1
2016,백창수,LG,10,1,0,1,0.0,0,0
2016,소사,LG,2,0,0,0,-,0,0
2016,유강남,LG,100,0,0,0,-,2,0
2016,윤지웅,LG,1,0,0,0,-,0,0
2016,이병규,LG,1,0,0,0,-,0,0
2016,이승현,LG,3,0,0,0,-,0,0
2016,임정우,LG,4,0,0,0,-,0,0
2016,장준원,LG,14,0,0,0,-,0,0
2016,정상호,LG,77,1,0,1,0.0,0,0
2016,정현욱,LG,1,0,0,0,-,0,0
2016,조윤준,LG,2,0,0,0,-,0,0
2016,진해수,LG,1,0,0,0,-,0,0
2016,최경철,LG,29,0,0,0,-,3,0
2016,최동환,LG,1,0,0,0,-,0,0
2016,홍창기,LG,3,0,0,0,-,0,0
2016,김동명,KT,21,0,0,0,-,0,0
2016,김만수,KT,1,0,0,0,-,0,0
2016,김사율,KT,1,0,0,0,-,0,0
2016,김상현,KT,62,1,0,1,0.0,3,0
2016,김영환,KT,12,0,0,0,-,1,0
2016,김재윤,KT,3,0,0,0,-,0,0
2016,김종민,KT,78,0,0,0,-,4,1
2016,김진곤,KT,13,0,0,0,-,0,0
2016,마르테,KT,91,0,0,0,-,2,0
2016,박기혁,KT,117,2,0,2,0.0,3,0
2016,박세진,KT,1,0,0,0,-,0,0
2016,박용근,KT,31,1,0,1,0.0,0,0
2016,배우열,KT,1,0,0,0,-,0,0
2016,신현철,KT,35,0,0,0,-,0,0
2016,심재민,KT,3,0,0,0,-,0,0
2016,엄상백,KT,2,0,0,0,-,0,0
2016,정성곤,KT,1,0,0,0,-,0,0
2016,정주후,KT,12,0,0,0,-,0,0
2016,홍성무,KT,1,0,0,0,-,0,0
2016,홍성용,KT,1,0,0,0,-,0,0
2017,박해민,삼성,144,52,40,12,76.9,3,2
2017,버나디나,KIA,139,39,32,7,82.1,8,1
2017,손아섭,롯데,144,33,25,8,75.8,4,0
2017,이대형,KT,100,27,23,4,85.2,0,2
2017,박건우,두산,131,23,20,3,87.0,3,1
2017,나경민,롯데,97,23,20,3,87.0,9,1
2017,심우준,KT,103,23,18,5,78.3,2,2
2017,나성범,NC,125,24,17,7,70.8,3,2
2017,고종욱,넥센,123,20,16,4,80.0,4,0
2017,김하성,넥센,141,24,16,8,66.7,6,0
2017,노수광,SK,131,25,16,9,64.0,2,1
2017,서건창,넥센,139,21,15,6,71.4,4,0
2017,오태곤,KT,135,24,15,9,62.5,5,1
2017,이상호,NC,95,14,12,2,85.7,4,1
2017,이정후,넥센,144,16,12,4,75.0,6,0
2017,강한울,삼성,135,19,12,7,63.2,4,0
2017,박민우,NC,106,12,11,1,91.7,4,0
2017,이형종,LG,128,17,11,6,64.7,2,0
2017,조용호,SK,69,13,11,2,84.6,3,1
2017,김헌곤,삼성,123,13,11,2,84.6,3,2
2017,김성욱,NC,124,14,10,4,71.4,2,0
2017,오지환,LG,107,15,10,5,66.7,4,1
2017,김강민,SK,88,14,10,4,71.4,0,1
2017,로사리오,한화,119,15,10,5,66.7,6,1
2017,이용규,한화,57,13,10,3,76.9,1,2
2017,번즈,롯데,116,17,10,7,58.8,12,2
2017,구자욱,삼성,144,14,10,4,71.4,3,0
2017,모창민,NC,136,15,9,6,60.0,6,1
2017,이재율,NC,52,10,9,1,90.0,2,1
2017,이종욱,NC,107,11,9,2,81.8,4,0
2017,김용의,LG,60,13,9,4,69.2,2,0
2017,김주찬,KIA,122,11,9,2,81.8,5,0
2017,김문호,롯데,131,13,9,4,69.2,5,0
2017,하준호,KT,101,14,9,5,64.3,3,1
2017,허경민,두산,130,12,8,4,66.7,3,0
2017,이천웅,LG,75,11,8,3,72.7,2,0
2017,이명기,KIA,115,15,8,7,53.3,2,0
2017,장민석,한화,88,12,8,4,66.7,3,1
2017,김재호,두산,91,8,7,1,87.5,4,2
2017,류지혁,두산,125,12,7,5,58.3,2,0
2017,오재원,두산,127,14,7,7,50.0,4,1
2017,안치홍,KIA,132,7,7,0,100.0,2,0
2017,하주석,한화,111,13,7,6,53.8,7,0
2017,정근우,한화,105,12,6,6,50.0,3,2
2017,채은성,LG,114,11,5,6,45.5,4,1
2017,신본기,롯데,128,7,5,2,71.4,2,2
2017,로하스,KT,83,13,5,8,38.5,4,0
2017,김재환,두산,144,5,4,1,80.0,4,0
2017,스크럭스,NC,115,4,4,0,100.0,7,1
2017,박용택,LG,138,6,4,2,66.7,7,0
2017,손주인,LG,115,4,4,0,100.0,2,0
2017,정성훈,LG,115,7,4,3,57.1,3,0
2017,김선빈,KIA,137,8,4,4,50.0,4,0
2017,정진기,SK,90,4,4,0,100.0,0,0
2017,양성우,한화,118,8,4,4,50.0,8,1
2017,이동훈,한화,67,6,4,2,66.7,0,0
2017,김동한,롯데,81,7,4,3,57.1,0,0
2017,황진수,롯데,60,4,4,0,100.0,0,0
2017,김성훈,삼성,47,6,4,2,66.7,1,0
2017,이지영,삼성,105,7,4,3,57.1,1,0
2017,정현,KT,124,6,4,2,66.7,3,1
2017,민병헌,두산,123,7,3,4,42.9,2,0
2017,조수행,두산,80,5,3,2,60.0,2,0
2017,최주환,두산,129,5,3,2,60.0,2,1
2017,권희동,NC,141,6,3,3,50.0,4,0
2017,박정음,넥센,81,7,3,4,42.9,4,0
2017,안익훈,LG,108,5,3,2,60.0,4,1
2017,양석환,LG,132,10,3,7,30.0,5,1
2017,최재원,LG,69,6,3,3,50.0,3,0
2017,히메네스,LG,51,8,3,5,37.5,2,0
2017,김민식,KIA,137,6,3,3,50.0,4,0
2017,김호령,KIA,98,5,3,2,60.0,0,0
2017,유재신,KIA,25,4,3,1,75.0,0,0
2017,최원준,KIA,72,5,3,2,60.0,4,1
2017,이대수,SK,58,3,3,0,100.0,2,0
2017,오선진,한화,65,8,3,5,37.5,0,0
2017,이성열,한화,81,3,3,0,100.0,4,1
2017,정훈,롯데,68,4,3,1,75.0,0,0
2017,김정혁,삼성,31,4,3,1,75.0,0,0
2017,조동찬,삼성,122,3,3,0,100.0,4,1
2017,박세혁,두산,97,3,2,1,66.7,2,0
2017,에반스,두산,138,2,2,0,100.0,1,0
2017,김준완,NC,104,4,2,2,50.0,2,0
2017,윤병호,NC,49,2,2,0,100.0,0,0
2017,박동원,넥센,103,3,2,1,66.7,7,0
2017,임병욱,넥센,21,2,2,0,100.0,1,0
2017,강승호,LG,85,4,2,2,50.0,1,2
2017,유강남,LG,118,2,2,0,100.0,1,0
2017,황목치승,LG,45,2,2,0,100.0,1,0
2017,신종길,KIA,64,3,2,1,66.7,0,1
2017,김동엽,SK,125,6,2,4,33.3,2,2
2017,김성현,SK,130,3,2,1,66.7,2,0
2017,한동민,SK,103,4,2,2,50.0,1,0
2017,송광민,한화,117,5,2,3,40.0,1,0
2017,정경운,한화,46,2,2,0,100.0,2,0
2017,문규현,롯데,110,3,2,1,66.7,1,1
2017,이우민,롯데,104,6,2,4,33.3,1,2
2017,전준우,롯데,110,6,2,4,33.3,2,1
2017,러프,삼성,134,4,2,2,50.0,12,0
2017,이원석,삼성,121,2,2,0,100.0,4,0
2017,김사연,KT,35,2,2,0,100.0,0,0
2017,모넬,KT,28,3,2,1,66.7,3,0
2017,박기혁,KT,97,3,2,1,66.7,4,0
2017,전민수,KT,55,3,2,1,66.7,1,0
2017,신성현,두산,34,1,1,0,100.0,0,0
2017,양의지,두산,111,2,1,1,50.0,3,0
2017,오재일,두산,128,2,1,1,50.0,1,1
2017,정진호,두산,97,2,1,1,50.0,2,2
2017,김종호,NC,3,1,1,0,100.0,0,0
2017,박석민,NC,101,3,1,2,33.3,4,0
2017,손시헌,NC,124,1,1,0,100.0,2,0
2017,이호준,NC,77,1,1,0,100.0,1,0
2017,지석훈,NC,121,1,1,0,100.0,4,0
2017,채상현,넥센,5,1,1,0,100.0,0,0
2017,허정협,넥센,83,3,1,2,33.3,0,0
2017,백창수,LG,52,1,1,0,100.0,1,2
2017,서상우,LG,10,1,1,0,100.0,0,0
2017,임훈,LG,42,3,1,2,33.3,0,1
2017,정주현,LG,15,1,1,0,100.0,1,0
2017,김지성,KIA,37,1,1,0,100.0,1,0
2017,나지완,KIA,137,2,1,1,50.0,4,2
2017,서동욱,KIA,125,2,1,1,50.0,3,0
2017,김재현,SK,14,3,1,2,33.3,0,0
2017,로맥,SK,102,2,1,1,50.0,3,1
2017,박정권,SK,118,2,1,1,50.0,2,0
2017,최정,SK,130,6,1,5,16.7,0,0
2017,강경학,한화,59,2,1,1,50.0,0,1
2017,김경언,한화,38,1,1,0,100,1,0
2017,임익준,한화,30,1,1,0,100,1,0
2017,차일목,한화,52,2,1,1,50.0,0,0
2017,김사훈,롯데,57,1,1,0,100,0,0
2017,이대호,롯데,142,2,1,1,50.0,4,0
2017,김상수,삼성,42,2,1,1,50.0,3,0
2017,배영섭,삼성,92,1,1,0,100,2,0
2017,안주형,삼성,10,2,1,1,50.0,2,0
2017,이승엽,삼성,135,2,1,1,50.0,9,1
2017,이현동,삼성,16,1,1,0,100,0,0
2017,정병곤,삼성,74,1,1,0,100,0,0
2017,최영진,삼성,14,1,1,0,100,0,0
2017,김동욱,KT,83,1,1,0,100,3,0
2017,김진곤,KT,28,1,1,0,100,1,0
2017,박경수,KT,131,3,1,2,33.3,7,0
2017,안치영,KT,21,3,1,2,33.3,1,0
2017,유민상,KT,15,1,1,0,100,0,0
2017,이해창,KT,114,5,1,4,20.0,4,1
2017,정주후,KT,7,1,1,0,100,0,0
2017,홍현빈,KT,8,1,1,0,100,0,0
2017,국해성,두산,57,0,0,0,-,0,0
2017,김강률,두산,3,0,0,0,-,0,0
2017,김명신,두산,1,0,0,0,-,0,0
2017,김민혁,두산,18,0,0,0,-,0,0
2017,김인태,두산,31,0,0,0,-,1,0
2017,박유연,두산,3,0,0,0,-,0,0
2017,서예일,두산,22,0,0,0,-,0,0
2017,이성곤,두산,4,0,0,0,-,0,0
2017,이용찬,두산,4,0,0,0,-,0,0
2017,이우성,두산,2,0,0,0,-,0,0
2017,황경태,두산,2,0,0,0,-,0,0
2017,강구성,NC,1,0,0,0,-,0,0
2017,강윤구,NC,2,0,0,0,-,0,0
2017,강진성,NC,28,0,0,0,-,1,0
2017,김종민,NC,22,0,0,0,-,0,0
2017,김진성,NC,1,0,0,0,-,0,0
2017,김찬형,NC,2,0,0,0,-,0,0
2017,김태군,NC,132,1,0,1,0.0,4,0
2017,김태우,NC,3,0,0,0,-,0,0
2017,노진혁,NC,4,0,0,0,-,0,0
2017,도태훈,NC,32,0,0,0,-,1,0
2017,박광열,NC,60,0,0,0,-,1,0
2017,신진호,NC,9,0,0,0,-,0,0
2017,원종현,NC,1,0,0,0,-,0,0
2017,유영준,NC,2,0,0,0,-,0,0
2017,윤수호,NC,8,0,0,0,-,0,0
2017,이민호,NC,4,0,0,0,-,0,0
2017,이원재,NC,2,0,0,0,-,0,0
2017,이재학,NC,1,0,0,0,-,0,0
2017,이형범,NC,2,0,0,0,-,0,0
2017,임정호,NC,2,0,0,0,-,0,0
2017,임창민,NC,3,0,0,0,-,0,0
2017,장현식,NC,1,0,0,0,-,0,0
2017,정수민,NC,1,0,0,0,-,0,0
2017,조영훈,NC,16,0,0,0,-,0,0
2017,조평호,NC,29,1,0,1,0.0,0,0
2017,최금강,NC,1,0,0,0,-,0,0
2017,최성영,NC,2,0,0,0,-,0,0
2017,황윤호,NC,36,0,0,0,-,3,1
2017,강지광,넥센,1,0,0,0,-,0,0
2017,김규민,넥센,14,0,0,0,-,0,0
2017,김민성,넥센,133,1,0,1,0.0,2,0
2017,김민준,넥센,12,0,0,0,-,0,0
2017,김상수,넥센,1,0,0,0,-,0,0
2017,김웅빈,넥센,67,0,0,0,-,1,0
2017,김재현,넥센,70,0,0,0,-,1,0
2017,김지수,넥센,64,1,0,1,0.0,2,0
2017,김태완,넥센,46,0,0,0,-,0,1
2017,김혜성,넥센,16,0,0,0,-,0,0
2017,대니돈,넥센,20,0,0,0,-,1,0
2017,박윤,넥센,9,0,0,0,-,0,0
2017,송성문,넥센,38,1,0,1,0.0,1,0
2017,이택근,넥센,100,0,0,0,-,1,0
2017,장영석,넥센,60,0,0,0,-,2,0
2017,주효상,넥센,64,0,0,0,-,5,0
2017,채태인,넥센,109,1,0,1,0.0,3,1
2017,초이스,넥센,46,0,0,0,-,2,0
2017,하영민,넥센,1,0,0,0,-,0,0
2017,한현희,넥센,1,0,0,0,-,0,0
2017,홍성갑,넥센,7,0,0,0,-,0,0
2017,고우석,LG,1,0,0,0,-,0,0
2017,김대현,LG,1,0,0,0,-,0,0
2017,김재율,LG,75,1,0,1,0.0,1,0
2017,김주성,LG,2,0,0,0,-,0,0
2017,김지용,LG,1,0,0,0,-,0,0
2017,로니,LG,23,0,0,0,-,1,0
2017,문선재,LG,35,3,0,3,0.0,1,0
2017,백승현,LG,9,1,0,1,0.0,0,0
2017,신정락,LG,2,0,0,0,-,0,0
2017,유재유,LG,1,0,0,0,-,0,0
2017,윤지웅,LG,1,0,0,0,-,0,0
2017,윤진호,LG,14,0,0,0,-,0,0
2017,이동현,LG,1,0,0,0,-,0,0
2017,이병규,LG,19,0,0,0,-,0,0
2017,장준원,LG,8,0,0,0,-,0,0
2017,정상호,LG,79,0,0,0,-,1,0
2017,정찬헌,LG,1,0,0,0,-,0,0
2017,조윤준,LG,25,0,0,0,-,1,0
2017,진해수,LG,1,0,0,0,-,0,0
2017,차우찬,LG,1,0,0,0,-,0,0
2017,최동환,LG,4,0,0,0,-,0,0
2017,최민창,LG,13,1,0,1,0.0,0,0
2017,고장혁,KIA,67,1,0,1,0.0,2,0
2017,고효준,KIA,1,0,0,0,-,0,0
2017,김광수,KIA,4,0,0,0,-,0,0
2017,김세현,KIA,1,0,0,0,-,0,0
2017,김윤동,KIA,2,0,0,0,-,0,0
2017,김주형,KIA,57,0,0,0,-,0,0
2017,김진우,KIA,1,0,0,0,-,0,0
2017,노관현,KIA,9,0,0,0,-,0,0
2017,박지훈,KIA,1,0,0,0,-,0,0
2017,박진태,KIA,7,0,0,0,-,0,0
2017,백용환,KIA,15,0,0,0,-,1,0
2017,손영민,KIA,2,0,0,0,-,0,0
2017,심동섭,KIA,5,0,0,0,-,0,0
2017,오준혁,KIA,14,0,0,0,-,0,0
2017,이범호,KIA,115,0,0,0,-,2,1
2017,이인행,KIA,3,0,0,0,-,0,0
2017,이정훈,KIA,4,0,0,0,-,0,0
2017,이진영,KIA,18,1,0,1,0.0,0,1
2017,이호신,KIA,12,1,0,1,0.0,0,0
2017,임기영,KIA,1,0,0,0,-,0,0
2017,임기준,KIA,1,0,0,0,-,0,0
2017,임창용,KIA,4,0,0,0,-,0,0
2017,최병연,KIA,3,0,0,0,-,0,0
2017,최영필,KIA,1,0,0,0,-,0,0
2017,최정민,KIA,8,0,0,0,-,0,0
2017,최형우,KIA,142,1,0,1,0.0,3,0
2017,한승택,KIA,96,0,0,0,-,1,0
2017,한승혁,KIA,6,0,0,0,-,0,0
2017,홍건희,KIA,2,0,0,0,-,0,0
2017,홍재호,KIA,2,0,0,0,-,0,0
2017,김주한,SK,2,0,0,0,-,0,0
2017,나주환,SK,122,3,0,3,0.0,2,0
2017,박성한,SK,2,0,0,0,-,0,0
2017,박승욱,SK,73,4,0,4,0.0,1,0
2017,서진용,SK,1,0,0,0,-,0,0
2017,워스,SK,3,0,0,0,-,0,0
2017,이성우,SK,64,0,0,0,-,0,0
2017,이재원,SK,114,1,0,1,0.0,3,0
2017,이홍구,SK,53,0,0,0,-,0,0
2017,전유수,SK,1,0,0,0,-,0,0
2017,정의윤,SK,112,1,0,1,0.0,5,1
2017,최승준,SK,31,0,0,0,-,2,0
2017,최정용,SK,5,1,0,1,0.0,1,0
2017,최항,SK,37,1,0,1,0.0,2,1
2017,허건엽,SK,1,0,0,0,-,0,0
2017,강상원,한화,33,0,0,0,-,0,0
2017,강승현,한화,1,0,0,0,-,0,0
2017,김원석,한화,78,0,0,0,-,6,1
2017,김주현,한화,24,0,0,0,-,2,1
2017,김태균,한화,94,0,0,0,-,3,1
2017,김태연,한화,12,0,0,0,-,0,0
2017,김회성,한화,54,0,0,0,-,0,0
2017,박상언,한화,4,0,0,0,-,0,0
2017,박상원,한화,1,0,0,0,-,0,0
2017,박준혁,한화,8,0,0,0,-,2,0
2017,송신영,한화,1,0,0,0,-,0,0
2017,심수창,한화,2,0,0,0,-,0,0
2017,안영명,한화,1,0,0,0,-,0,0
2017,이동걸,한화,1,0,0,0,-,0,0
2017,이양기,한화,17,0,0,0,-,0,0
2017,이종환,한화,1,0,0,0,-,0,0
2017,이창열,한화,3,0,0,0,-,0,0
2017,정범모,한화,22,0,0,0,-,0,0
2017,정우람,한화,1,0,0,0,-,0,0
2017,정현석,한화,9,0,0,0,-,0,0
2017,조인성,한화,16,0,0,0,-,0,0
2017,최윤석,한화,21,0,0,0,-,0,0
2017,최재훈,한화,104,2,0,2,0.0,4,0
2017,최진행,한화,89,2,0,2,0.0,3,0
2017,허도환,한화,30,0,0,0,-,1,0
2017,강동관,롯데,1,0,0,0,-,0,0
2017,강민호,롯데,130,2,0,2,0.0,3,0
2017,김대륙,롯데,50,0,0,0,-,1,0
2017,김대우,롯데,12,0,0,0,-,1,1
2017,김민수,롯데,10,0,0,0,-,0,0
2017,김상호,롯데,80,3,0,3,0.0,1,0
2017,김재유,롯데,1,0,0,0,-,0,0
2017,김주현,롯데,2,0,0,0,-,0,0
2017,나종덕,롯데,5,0,0,0,-,1,0
2017,노경은,롯데,2,0,0,0,-,0,0
2017,박시영,롯데,1,0,0,0,-,0,0
2017,박헌도,롯데,56,0,0,0,-,0,0
2017,손승락,롯데,4,0,0,0,-,0,0
2017,윤길현,롯데,1,0,0,0,-,0,0
2017,이명우,롯데,1,0,0,0,-,0,0
2017,장시환,롯데,2,0,0,0,-,0,0
2017,최준석,롯데,125,0,0,0,-,4,0
2017,권정웅,삼성,61,0,0,0,-,0,0
2017,김동호,삼성,1,0,0,0,-,0,0
2017,김민수,삼성,13,0,0,0,-,0,0
2017,김성윤,삼성,22,0,0,0,-,0,0
2017,김승현,삼성,1,0,0,0,-,0,0
2017,나성용,삼성,6,1,0,1,0.0,0,0
2017,나원탁,삼성,12,0,0,0,-,0,0
2017,문선엽,삼성,4,0,0,0,-,0,0
2017,박근홍,삼성,1,0,0,0,-,0,0
2017,박한이,삼성,68,0,0,0,-,1,0
2017,백상원,삼성,28,0,0,0,-,0,0
2017,성의준,삼성,11,0,0,0,-,0,0
2017,심창민,삼성,1,0,0,0,-,0,0
2017,우동균,삼성,8,0,0,0,-,0,0
2017,이성규,삼성,15,0,0,0,-,0,0
2017,이영욱,삼성,6,0,0,0,-,0,0
2017,장필준,삼성,3,0,0,0,-,0,0
2017,최경철,삼성,25,0,0,0,-,1,0
2017,최원제,삼성,11,0,0,0,-,0,0
2017,최충연,삼성,1,0,0,0,-,0,0
2017,강장산,KT,1,0,0,0,-,0,0
2017,김만수,KT,10,0,0,0,-,1,0
2017,김사율,KT,1,0,0,0,-,0,0
2017,김연훈,KT,19,0,0,0,-,0,0
2017,김재윤,KT,5,0,0,0,-,0,0
2017,남태혁,KT,31,0,0,0,-,0,0
2017,류희운,KT,1,0,0,0,-,0,0
2017,배우열,KT,1,0,0,0,-,0,0
2017,배제성,KT,1,0,0,0,-,0,0
2017,심재민,KT,1,0,0,0,-,0,0
2017,엄상백,KT,3,0,0,0,-,0,0
2017,오정복,KT,81,1,0,1,0.0,2,0
2017,유한준,KT,133,2,0,2,0.0,2,0
2017,윤근영,KT,1,0,0,0,-,0,0
2017,윤석민,KT,142,1,0,1,0.0,7,0
2017,윤요섭,KT,22,0,0,0,-,0,0
2017,이상화,KT,4,0,0,0,-,0,0
2017,이재근,KT,6,0,0,0,-,0,0
2017,이진영,KT,103,0,0,0,-,2,0
2017,장성우,KT,118,4,0,4,0.0,2,0
2017,조무근,KT,1,0,0,0,-,0,0
2017,주권,KT,2,0,0,0,-,0,0
2017,홍성무,KT,1,0,0,0,-,0,0
2017,홍성용,KT,2,0,0,0,-,0,0
2018,박해민,삼성,144,46,36,10,78.3,7,1
2018,버나디나,KIA,131,45,32,13,71.1,6,3
2018,김혜성,넥센,136,37,31,6,83.8,6,3
2018,이용규,한화,134,41,30,11,73.2,8,0
2018,노수광,SK,135,29,25,4,86.2,6,1
2018,호잉,한화,142,32,23,9,71.9,4,2
2018,김헌곤,삼성,141,31,22,9,71.0,8,1
2018,허경민,두산,133,24,20,4,83.3,6,0
2018,손아섭,롯데,141,23,20,3,87.0,5,1
2018,정주현,LG,115,21,18,3,85.7,3,0
2018,로하스,KT,144,31,18,13,58.1,5,2
2018,박민우,NC,115,22,17,5,77.3,4,1
2018,고종욱,넥센,102,21,17,4,81.0,6,0
2018,임병욱,넥센,134,19,16,3,84.2,3,0
2018,오재원,두산,132,21,15,6,71.4,5,2
2018,나성범,NC,144,17,15,2,88.2,3,2
2018,하주석,한화,141,26,14,12,53.8,3,2
2018,황재균,KT,142,21,14,7,66.7,8,0
2018,이상호,NC,114,18,13,5,72.2,3,1
2018,오태곤,KT,128,21,13,8,61.9,4,0
2018,이명기,KIA,120,17,12,5,70.6,5,0
2018,나경민,롯데,87,16,12,4,75.0,2,2
2018,김상수,삼성,122,21,12,9,57.1,2,0
2018,김성훈,삼성,110,18,12,6,66.7,3,0
2018,김성욱,NC,111,13,11,2,84.6,4,0
2018,김동엽,SK,124,13,11,2,84.6,5,2
2018,정진기,SK,96,14,11,3,78.6,1,0
2018,이정후,넥센,109,15,11,4,73.3,5,3
2018,심우준,KT,135,22,11,11,50.0,2,0
2018,최원준,KIA,101,14,10,4,71.4,3,0
2018,김강민,SK,80,16,10,6,62.5,4,1
2018,로맥,SK,141,15,10,5,66.7,7,1
2018,김용의,LG,114,11,10,1,90.9,0,1
2018,오지환,LG,144,15,10,5,66.7,2,3
2018,이천웅,LG,112,20,10,10,50.0,2,0
2018,구자욱,삼성,116,10,10,0,100.0,4,0
2018,조수행,두산,119,9,9,0,100.0,1,1
2018,최정,SK,115,11,9,2,81.8,2,0
2018,이성열,한화,131,16,9,7,56.3,2,0
2018,김주찬,KIA,121,9,8,1,88.9,2,0
2018,정진호,두산,111,9,8,1,88.9,1,0
2018,민병헌,롯데,118,11,8,3,72.7,3,1
2018,김규민,넥센,104,12,8,4,66.7,2,0
2018,김하성,넥센,129,10,8,2,80.0,8,0
2018,최재훈,한화,128,8,8,0,100.0,6,0
2018,류지혁,두산,128,9,7,2,77.8,2,1
2018,박건우,두산,125,10,7,3,70.0,8,1
2018,전준우,롯데,144,14,7,7,50.0,4,3
2018,김재현,SK,53,8,7,1,87.5,2,0
2018,김재호,두산,131,8,6,2,75.0,5,1
2018,양의지,두산,133,6,6,0,100.0,6,0
2018,김성현,SK,135,8,6,2,75.0,4,0
2018,이형종,LG,118,10,6,4,60.0,5,2
2018,강경학,한화,77,9,6,3,66.7,1,2
2018,정근우,한화,102,11,6,5,54.5,8,0
2018,김민식,KIA,125,7,5,2,71.4,5,0
2018,안치홍,KIA,130,6,5,1,83.3,3,0
2018,박세혁,두산,89,5,5,0,100.0,0,0
2018,정수빈,두산,26,7,5,2,71.4,1,0
2018,번즈,롯데,133,7,5,2,71.4,3,1
2018,나주환,SK,119,11,5,6,45.5,4,0
2018,가르시아,LG,50,5,5,0,100.0,3,0
2018,김민하,한화,59,10,5,5,50.0,1,0
2018,정은원,한화,98,6,5,1,83.3,1,2
2018,러프,삼성,137,8,5,3,62.5,3,1
2018,박한이,삼성,114,8,5,3,62.5,2,0
2018,김선빈,KIA,127,5,4,1,80.0,6,1
2018,유재신,KIA,46,4,4,0,100.0,4,0
2018,정훈,롯데,91,6,4,2,66.7,2,0
2018,김찬형,NC,63,5,4,1,80.0,0,1
2018,노진혁,NC,125,7,4,3,57.1,6,0
2018,박승욱,SK,51,5,4,1,80.0,1,2
2018,한동민,SK,136,6,4,2,66.7,4,1
2018,송광민,한화,113,8,4,4,50.0,5,0
2018,박경수,KT,135,5,4,1,80.0,6,0
2018,윤석민,KT,132,5,4,1,80.0,3,0
2018,최형우,KIA,143,3,3,0,100.0,5,0
2018,김동한,롯데,55,4,3,1,75.0,3,0
2018,문규현,롯데,122,4,3,1,75.0,1,0
2018,전병우,롯데,27,3,3,0,100.0,0,1
2018,스크럭스,NC,142,5,3,2,60.0,7,1
2018,이재율,NC,33,4,3,1,75.0,0,1
2018,박용택,LG,134,6,3,3,50.0,7,0
2018,채은성,LG,139,4,3,1,75.0,1,1
2018,오선진,한화,56,3,3,0,100.0,0,0
2018,강한울,삼성,83,7,3,4,42.9,2,0
2018,박찬도,삼성,54,6,3,3,50.0,0,0
2018,손주인,삼성,98,3,3,0,100.0,1,0
2018,강백호,KT,138,8,3,5,37.5,9,2
2018,정현,KT,65,3,3,0,100.0,3,1
2018,황윤호,KIA,82,4,2,2,50.0,2,0
2018,김재환,두산,139,2,2,0,100.0,3,0
2018,모창민,NC,81,5,2,3,40.0,3,0
2018,손시헌,NC,67,2,2,0,100.0,0,0
2018,윤정우,SK,22,3,2,1,66.7,0,0
2018,최항,SK,98,4,2,2,50.0,3,0
2018,박지규,LG,26,2,2,0,100.0,1,0
2018,양석환,LG,140,4,2,2,50.0,5,0
2018,서건창,넥센,37,2,2,0,100.0,0,0
2018,송성문,넥센,78,6,2,4,33.3,2,0
2018,초이스,넥센,96,3,2,1,66.7,0,0
2018,이원석,삼성,128,3,2,1,66.7,5,0
2018,최영진,삼성,61,6,2,4,33.3,2,1
2018,송민섭,KT,47,3,2,1,66.7,0,0
2018,이진영,KT,110,3,2,1,66.7,6,0
2018,이범호,KIA,101,1,1,0,100.0,3,0
2018,이영욱,KIA,14,1,1,0,100.0,2,0
2018,최정민,KIA,57,4,1,3,25.0,1,1
2018,국해성,두산,14,1,1,0,100.0,1,0
2018,오재일,두산,123,2,1,1,50.0,4,0
2018,이병휘,두산,28,2,1,1,50.0,1,0
2018,최주환,두산,138,1,1,0,100.0,5,0
2018,파레디스,두산,21,1,1,0,100.0,0,0
2018,김문호,롯데,46,1,1,0,100.0,2,1
2018,신본기,롯데,139,6,1,5,16.7,5,0
2018,황진수,롯데,18,1,1,0,100.0,0,0
2018,권희동,NC,104,4,1,3,25.0,4,0
2018,김태진,NC,20,3,1,2,33.3,1,0
2018,박석민,NC,103,1,1,0,100.0,3,0
2018,박헌욱,NC,10,1,1,0,100.0,0,0
2018,윤병호,NC,14,1,1,0,100,0,0
2018,이우성,NC,71,3,1,2,33.3,2,0
2018,이종욱,NC,43,2,1,1,50.0,1,0
2018,정범모,NC,103,1,1,0,100,2,0
2018,지석훈,NC,67,1,1,0,100,1,0
2018,강승호,SK,69,2,1,1,50.0,5,0
2018,이성우,SK,88,1,1,0,100,1,0
2018,정의윤,SK,73,2,1,1,50.0,1,0
2018,김현수,LG,117,4,1,3,25.0,5,0
2018,김민성,넥센,128,1,1,0,100,1,0
2018,이택근,넥센,104,1,1,0,100,2,0
2018,장영석,넥센,93,1,1,0,100,0,0
2018,주효상,넥센,80,3,1,2,33.3,2,0
2018,강상원,한화,6,1,1,0,100,0,0
2018,김회성,한화,58,1,1,0,100,1,0
2018,양성우,한화,73,2,1,1,50.0,1,1
2018,장진혁,한화,50,3,1,2,33.3,2,0
2018,지성준,한화,99,1,1,0,100,2,0
2018,배영섭,삼성,69,1,1,0,100,0,0
2018,김지열,KT,38,2,1,1,50.0,0,0
2018,박기혁,KT,98,1,1,0,100,2,0
2018,오준혁,KT,30,2,1,1,50.0,0,0
2018,유한준,KT,121,2,1,1,50.0,1,2
2018,장성우,KT,127,2,1,1,50.0,9,0
2018,홍현빈,KT,14,1,1,0,100,0,0
2018,김석환,KIA,1,0,0,0,-,0,0
2018,김세현,KIA,5,0,0,0,-,0,0
2018,김유신,KIA,2,0,0,0,-,0,0
2018,김윤동,KIA,2,0,0,0,-,0,0
2018,김주형,KIA,6,0,0,0,-,0,0
2018,김지성,KIA,1,0,0,0,-,0,0
2018,나지완,KIA,114,0,0,0,-,1,1
2018,류승현,KIA,35,0,0,0,-,1,0
2018,문경찬,KIA,7,0,0,0,-,0,0
2018,박준태,KIA,85,2,0,2,0.0,0,0
2018,백용환,KIA,34,1,0,1,0.0,1,0
2018,서동욱,KIA,32,0,0,0,-,0,0
2018,신범수,KIA,19,0,0,0,-,0,0
2018,심동섭,KIA,1,0,0,0,-,0,0
2018,유민상,KIA,31,0,0,0,-,1,0
2018,유승철,KIA,5,0,0,0,-,0,0
2018,윤석민,KIA,1,0,0,0,-,0,0
2018,이민우,KIA,1,0,0,0,-,0,0
2018,이인행,KIA,4,0,0,0,-,0,0
2018,이창진,KIA,20,1,0,1,0.0,0,0
2018,임기영,KIA,2,0,0,0,-,0,0
2018,임기준,KIA,4,0,0,0,-,0,0
2018,임창용,KIA,1,0,0,0,-,0,0
2018,정성훈,KIA,88,1,0,1,0.0,1,0
2018,팻딘,KIA,2,0,0,0,-,0,0
2018,하준영,KIA,1,0,0,0,-,0,0
2018,한승택,KIA,61,0,0,0,-,1,0
2018,한승혁,KIA,1,0,0,0,-,0,0
2018,헥터,KIA,1,0,0,0,-,0,0
2018,홍건희,KIA,1,0,0,0,-,0,0
2018,홍재호,KIA,56,0,0,0,-,0,0
2018,황인준,KIA,5,0,0,0,-,0,0
2018,김민혁,두산,22,0,0,0,-,0,0
2018,김인태,두산,46,0,0,0,-,0,0
2018,김정후,두산,2,0,0,0,-,0,0
2018,박성모,두산,1,0,0,0,-,0,0
2018,반슬라이크,두산,12,0,0,0,-,0,0
2018,백민기,두산,23,0,0,0,-,1,0
2018,변진수,두산,1,0,0,0,-,0,0
2018,신성현,두산,16,0,0,0,-,0,0
2018,양종민,두산,21,0,0,0,-,0,0
2018,유재유,두산,1,0,0,0,-,0,0
2018,이영하,두산,1,0,0,0,-,0,0
2018,이현승,두산,1,0,0,0,-,0,0
2018,이흥련,두산,7,0,0,0,-,1,0
2018,장승현,두산,20,0,0,0,-,0,0
2018,전민재,두산,12,0,0,0,-,1,0
2018,함덕주,두산,3,0,0,0,-,0,0
2018,황경태,두산,27,1,0,1,0.0,1,1
2018,구승민,롯데,1,0,0,0,-,0,0
2018,김사훈,롯데,56,0,0,0,-,2,0
2018,나원탁,롯데,20,0,0,0,-,0,0
2018,나종덕,롯데,106,0,0,0,-,0,0
2018,노경은,롯데,1,0,0,0,-,0,0
2018,박헌도,롯데,15,0,0,0,-,0,0
2018,손승락,롯데,1,0,0,0,-,0,0
2018,안중열,롯데,60,0,0,0,-,0,0
2018,오윤석,롯데,13,0,0,0,-,1,0
2018,윤성빈,롯데,1,0,0,0,-,0,0
2018,이대호,롯데,144,1,0,1,0.0,7,0
2018,이병규,롯데,103,0,0,0,-,0,0
2018,장시환,롯데,1,0,0,0,-,0,0
2018,조정훈,롯데,1,0,0,0,-,0,0
2018,조홍석,롯데,39,2,0,2,0.0,1,0
2018,진명호,롯데,1,0,0,0,-,0,0
2018,채태인,롯데,130,0,0,0,-,4,0
2018,한동희,롯데,87,1,0,1,0.0,0,0
2018,허일,롯데,9,0,0,0,-,1,0
2018,강구성,NC,4,0,0,0,-,0,0
2018,강민국,NC,6,0,0,0,-,0,0
2018,강윤구,NC,3,0,0,0,-,0,0
2018,강진성,NC,45,0,0,0,-,1,0
2018,김종민,NC,6,0,0,0,-,0,0
2018,김진성,NC,2,0,0,0,-,0,0
2018,김철호,NC,1,0,0,0,-,0,0
2018,김형준,NC,60,0,0,0,-,0,1
2018,도태훈,NC,26,0,0,0,-,1,0
2018,박광열,NC,27,0,0,0,-,1,0
2018,박진우,NC,1,0,0,0,-,0,0
2018,배재환,NC,1,0,0,0,-,0,0
2018,신진호,NC,20,0,0,0,-,1,0
2018,오영수,NC,11,1,0,1,0.0,0,0
2018,유원상,NC,1,0,0,0,-,0,0
2018,윤수강,NC,44,0,0,0,-,0,0
2018,이민호,NC,5,0,0,0,-,0,0
2018,이원재,NC,77,2,0,2,0.0,1,0
2018,이인혁,NC,2,0,0,0,-,0,0
2018,임창민,NC,1,0,0,0,-,0,0
2018,정수민,NC,1,0,0,0,-,0,0
2018,조원빈,NC,2,0,0,0,-,0,0
2018,최준석,NC,93,0,0,0,-,0,0
2018,강지광,SK,1,0,0,0,-,0,0
2018,박성한,SK,42,0,0,0,-,0,0
2018,박정권,SK,14,0,0,0,-,0,0
2018,박정배,SK,4,0,0,0,-,0,0
2018,박희수,SK,2,0,0,0,-,0,0
2018,신재웅,SK,3,0,0,0,-,0,0
2018,안상현,SK,1,0,0,0,-,0,0
2018,윤희상,SK,1,0,0,0,-,0,0
2018,이대수,SK,4,0,0,0,-,0,0
2018,이윤재,SK,1,0,0,0,-,0,0
2018,이재원,SK,130,0,0,0,-,4,1
2018,조용호,SK,16,1,0,1,0.0,0,0
2018,최승준,SK,27,0,0,0,-,0,1
2018,허도환,SK,23,0,0,0,-,0,0
2018,김기연,LG,2,0,0,0,-,0,0
2018,김재율,LG,25,0,0,0,-,0,0
2018,문선재,LG,2,0,0,0,-,0,0
2018,문성주,LG,5,0,0,0,-,1,0
2018,백승현,LG,5,0,0,0,-,0,0
2018,서상우,LG,51,1,0,1,0.0,0,0
2018,안익훈,LG,62,1,0,1,0.0,2,0
2018,양원혁,LG,7,0,0,0,-,0,0
2018,유강남,LG,132,0,0,0,-,4,0
2018,윤대영,LG,11,0,0,0,-,1,0
2018,윤진호,LG,102,1,0,1,0.0,1,0
2018,임훈,LG,54,0,0,0,-,0,0
2018,장시윤,LG,8,0,0,0,-,0,0
2018,정상호,LG,70,1,0,1,0.0,1,0
2018,홍창기,LG,12,1,0,1,0.0,1,0
2018,김성민,넥센,1,0,0,0,-,0,0
2018,김재현,넥센,116,0,0,0,-,3,0
2018,김종덕,넥센,3,0,0,0,-,0,0
2018,김지수,넥센,47,1,0,1,0.0,0,0
2018,김태완,넥센,29,0,0,0,-,0,0
2018,박동원,넥센,39,0,0,0,-,0,0
2018,박병호,넥센,113,1,0,1,0.0,3,0
2018,박정음,넥센,16,0,0,0,-,0,0
2018,브리검,넥센,1,0,0,0,-,0,0
2018,샌즈,넥센,25,1,0,1,0.0,1,0
2018,예진원,넥센,5,0,0,0,-,1,0
2018,조상우,넥센,1,0,0,0,-,0,0
2018,허정협,넥센,25,0,0,0,-,0,0
2018,홍성갑,넥센,6,0,0,0,-,0,0
2018,김인환,한화,4,0,0,0,-,0,0
2018,김창혁,한화,6,0,0,0,-,0,0
2018,김태균,한화,73,1,0,1,0.0,5,0
2018,김태연,한화,24,1,0,1,0.0,0,0
2018,박준혁,한화,4,0,0,0,-,0,0
2018,백창수,한화,70,0,0,0,-,3,0
2018,송창식,한화,1,0,0,0,-,0,0
2018,안영명,한화,2,0,0,0,-,0,0
2018,이도윤,한화,2,0,0,0,-,0,0
2018,이동걸,한화,1,0,0,0,-,0,0
2018,이동훈,한화,28,1,0,1,0.0,1,0
2018,장민재,한화,1,0,0,0,-,0,0
2018,정경운,한화,22,0,0,0,-,0,0
2018,최윤석,한화,2,0,0,0,-,0,0
2018,최진행,한화,57,1,0,1,0.0,4,1
2018,강민호,삼성,129,0,0,0,-,4,0
2018,권정웅,삼성,6,0,0,0,-,0,0
2018,김민수,삼성,8,0,0,0,-,0,0
2018,김성윤,삼성,1,0,0,0,-,0,0
2018,김응민,삼성,1,0,0,0,-,0,0
2018,김재현,삼성,5,0,0,0,-,0,0
2018,김호재,삼성,10,0,0,0,-,1,0
2018,백상원,삼성,4,0,0,0,-,0,0
2018,백승민,삼성,14,0,0,0,-,0,0
2018,송준석,삼성,4,0,0,0,-,0,0
2018,안주형,삼성,15,0,0,0,-,2,0
2018,이성곤,삼성,9,0,0,0,-,0,0
2018,이지영,삼성,90,0,0,0,-,0,0
2018,장필준,삼성,1,0,0,0,-,0,0
2018,정병곤,삼성,6,0,0,0,-,0,0
2018,정인욱,삼성,1,0,0,0,-,0,0
2018,조동찬,삼성,28,0,0,0,-,0,0
2018,최원제,삼성,8,0,0,0,-,0,0
2018,고명성,KT,5,0,0,0,-,0,0
2018,고창성,KT,1,0,0,0,-,0,0
2018,김동욱,KT,11,0,0,0,-,0,0
2018,김사율,KT,1,0,0,0,-,0,0
2018,김영환,KT,4,0,0,0,-,0,0
2018,김재윤,KT,6,0,0,0,-,0,0
2018,김진곤,KT,19,2,0,2,0.0,0,0
2018,남태혁,KT,7,0,0,0,-,0,0
2018,배정대,KT,14,0,0,0,-,1,0
2018,신병률,KT,2,0,0,0,-,0,0
2018,엄상백,KT,1,0,0,0,-,0,0
2018,오정복,KT,5,0,0,0,-,0,0
2018,이대형,KT,1,0,0,0,-,0,0
2018,이종혁,KT,1,0,0,0,-,0,0
2018,이준수,KT,11,0,0,0,-,0,0
2018,이해창,KT,83,3,0,3,0.0,2,0
2018,전민수,KT,21,0,0,0,-,2,0
2018,하준호,KT,15,0,0,0,-,0,0
2018,홍성용,KT,1,0,0,0,-,0,0
2019,박찬호,KIA,133,45,39,6,86.7,8,3
2019,김하성,키움,139,37,33,4,89.2,3,1
2019,고종욱,SK,137,41,31,10,75.6,8,1
2019,노수광,SK,117,37,27,10,73.0,7,1
2019,오지환,LG,134,32,27,5,84.4,5,2
2019,정수빈,두산,123,34,26,8,76.5,10,2
2019,박해민,삼성,144,31,24,7,77.4,4,2
2019,심우준,KT,138,27,24,3,88.9,3,1
2019,호잉,한화,124,29,22,7,75.9,6,0
2019,김민혁,KT,127,32,22,10,68.8,2,3
2019,김상수,삼성,129,24,21,3,87.5,3,0
2019,이천웅,LG,138,31,21,10,67.7,3,0
2019,김혜성,키움,122,23,20,3,87.0,2,0
2019,오태곤,KT,123,21,19,2,90.5,2,0
2019,류지혁,두산,118,23,18,5,78.3,3,1
2019,박민우,NC,125,25,18,7,72.0,5,0
2019,서건창,키움,113,20,17,3,85.0,6,3
2019,김강민,SK,127,23,15,8,65.2,3,1
2019,이학주,삼성,118,20,15,5,75.0,7,0
2019,정주현,LG,129,21,15,6,71.4,4,1
2019,정은원,한화,142,21,14,7,66.7,6,2
2019,이명기,NC,139,18,14,4,77.8,5,1
2019,김재현,SK,83,19,13,6,68.4,2,2
2019,장진혁,한화,113,18,13,5,72.2,7,1
2019,이정후,키움,140,20,13,7,65.0,4,0
2019,민병헌,롯데,101,19,13,6,68.4,6,0
2019,손아섭,롯데,134,21,13,8,61.9,3,1
2019,박건우,두산,127,15,12,3,80.0,9,1
2019,김태진,NC,123,16,12,4,75.0,6,2
2019,허경민,두산,133,16,11,5,68.8,7,2
2019,구자욱,삼성,122,14,11,3,78.6,8,0
2019,임병욱,키움,117,12,10,2,83.3,3,1
2019,김헌곤,삼성,114,18,10,8,55.6,3,1
2019,신민재,LG,81,18,10,8,55.6,2,1
2019,황재균,KT,124,17,10,7,58.8,6,1
2019,이상호,NC,102,15,10,5,66.7,4,1
2019,강백호,KT,116,14,9,5,64.3,3,0
2019,박세혁,두산,137,10,8,2,80.0,6,0
2019,송광민,한화,122,10,8,2,80.0,5,0
2019,이성열,한화,129,12,8,4,66.7,3,0
2019,정근우,한화,88,13,8,5,61.5,5,0
2019,이창진,KIA,133,16,8,8,50.0,3,1
2019,최원준,KIA,90,12,8,4,66.7,4,0
2019,전준우,롯데,141,10,8,2,80.0,7,1
2019,김용의,LG,114,11,8,3,72.7,1,0
2019,안상현,SK,65,10,7,3,70.0,2,0
2019,오선진,한화,122,9,7,2,77.8,3,0
2019,강로한,롯데,104,8,7,1,87.5,3,2
2019,김성현,SK,144,8,6,2,75.0,5,0
2019,로맥,SK,137,9,6,3,66.7,3,0
2019,오재원,두산,98,8,6,2,75.0,1,1
2019,박정음,키움,60,11,6,5,54.5,1,0
2019,러프,삼성,133,9,6,3,66.7,6,0
2019,이형종,LG,120,11,6,5,54.5,4,0
2019,김성욱,NC,116,10,6,4,60.0,2,0
2019,최승민,NC,24,8,6,2,75.0,0,0
2019,이유찬,두산,25,5,5,0,100.0,0,0
2019,정진호,두산,66,7,5,2,71.4,1,0
2019,김민하,한화,72,7,5,2,71.4,2,0
2019,이지영,키움,106,6,5,1,83.3,2,1
2019,김선빈,KIA,121,9,5,4,55.6,5,0
2019,박계범,삼성,58,6,5,1,83.3,1,1
2019,안치홍,KIA,105,6,4,2,66.7,5,0
2019,유재신,KIA,71,7,4,3,57.1,2,0
2019,김성훈,삼성,65,7,4,3,57.1,0,2
2019,최영진,삼성,96,5,4,1,80.0,1,0
2019,아수아헤,롯데,49,6,4,2,66.7,2,1
2019,정훈,롯데,88,7,4,3,57.1,2,0
2019,로하스,KT,142,8,4,4,50.0,10,1
2019,박승욱,KT,101,5,4,1,80.0,6,0
2019,양의지,NC,118,7,4,3,57.1,2,1
2019,채현우,SK,9,4,3,1,75.0,0,0
2019,최정,SK,141,5,3,2,60.0,3,1
2019,김재호,두산,130,6,3,3,50.0,5,0
2019,김재환,두산,136,4,3,1,75.0,2,0
2019,김태균,한화,127,3,3,0,100.0,6,1
2019,유장혁,한화,38,3,3,0,100.0,1,0
2019,이동훈,한화,14,3,3,0,100.0,1,0
2019,최재훈,한화,135,13,3,10,23.1,2,0
2019,김주찬,KIA,100,4,3,1,75.0,4,1
2019,류승현,KIA,57,5,3,2,60.0,1,0
2019,김동한,롯데,42,5,3,2,60.0,0,0
2019,신본기,롯데,121,6,3,3,50.0,1,1
2019,김현수,LG,140,4,3,1,75.0,4,0
2019,박용택,LG,64,4,3,1,75.0,0,0
2019,홍창기,LG,23,3,3,0,100.0,0,0
2019,유한준,KT,139,3,3,0,100.0,3,0
2019,조용호,KT,87,7,3,4,42.9,5,0
2019,권희동,NC,116,3,3,0,100.0,2,0
2019,김찬형,NC,76,7,3,4,42.9,3,0
2019,모창민,NC,101,5,3,2,60.0,1,0
2019,스몰린스키,NC,55,4,3,1,75.0,2,0
2019,배영섭,SK,30,2,2,0,100.0,0,0
2019,최항,SK,52,2,2,0,100.0,0,1
2019,오재일,두산,130,3,2,1,66.7,2,0
2019,김회성,한화,58,3,2,1,66.7,0,0
2019,노시환,한화,91,4,2,2,50.0,0,1
2019,이원석,한화,13,2,2,0,100.0,2,1
2019,김규민,키움,94,6,2,4,33.3,1,0
2019,송성문,키움,103,3,2,1,66.7,1,0
2019,김민식,KIA,53,2,2,0,100.0,1,1
2019,문선재,KIA,29,3,2,1,66.7,1,0
2019,황윤호,KIA,57,4,2,2,50.0,3,0
2019,김동엽,삼성,60,3,2,1,66.7,4,0
2019,이원석,삼성,111,3,2,1,66.7,1,0
2019,김문호,롯데,51,2,2,0,100.0,0,0
2019,나경민,롯데,45,2,2,0,100.0,1,0
2019,허일,롯데,71,3,2,1,66.7,0,0
2019,구본혁,LG,57,3,2,1,66.7,0,0
2019,김민성,LG,107,3,2,1,66.7,2,0
2019,전민수,LG,75,3,2,1,66.7,0,0
2019,채은성,LG,128,4,2,2,50.0,1,1
2019,페게로,LG,52,3,2,1,66.7,0,1
2019,강민국,KT,58,2,2,0,100.0,1,0
2019,문상철,KT,33,2,2,0,100.0,0,0
2019,강진성,NC,41,3,2,1,66.7,0,0
2019,나성범,NC,23,3,2,1,66.7,4,0
2019,나주환,SK,94,3,1,2,33.3,2,2
2019,이재원,SK,139,1,1,0,100.0,3,1
2019,정현,SK,27,2,1,1,50.0,0,0
2019,김인태,두산,26,2,1,1,50.0,1,0
2019,김태근,두산,9,3,1,2,33.3,0,0
2019,페르난데스,두산,144,3,1,2,33.3,3,0
2019,강경학,한화,52,3,1,2,33.3,0,0
2019,양성우,한화,56,1,1,0,100,0,0
2019,박동원,키움,112,1,1,0,100,3,0
2019,샌즈,키움,139,3,1,2,33.3,5,0
2019,박준태,KIA,38,2,1,1,50.0,0,0
2019,한승택,KIA,105,1,1,0,100,4,0
2019,해즐베이커,KIA,11,2,1,1,50.0,0,0
2019,박승규,삼성,14,2,1,1,50.0,0,0
2019,이성규,삼성,16,2,1,1,50.0,1,0
2019,최선호,삼성,17,1,1,0,100,0,0
2019,배성근,롯데,36,1,1,0,100,0,0
2019,윌슨,롯데,68,3,1,2,33.3,7,0
2019,조홍석,롯데,42,1,1,0,100,0,0
2019,한동희,롯데,59,1,1,0,100,1,0
2019,백승현,LG,14,1,1,0,100,0,0
2019,윤진호,LG,106,2,1,1,50.0,1,0
2019,김진곤,KT,19,2,1,1,50.0,2,0
2019,송민섭,KT,105,4,1,3,25.0,1,1
2019,박석민,NC,112,3,1,2,33.3,4,1
2019,베탄코트,NC,53,2,1,1,50.0,1,0
2019,손시헌,NC,68,3,1,2,33.3,1,1
2019,이원재,NC,94,3,1,2,33.3,4,0
2019,정범모,NC,25,2,1,1,50.0,0,0
2019,강승호,SK,15,0,0,0,-,0,0
2019,김성민,SK,2,0,0,0,-,0,1
2019,김창평,SK,18,0,0,0,-,1,0
2019,김태훈,SK,1,0,0,0,-,0,0
2019,남태혁,SK,12,0,0,0,-,0,0
2019,박정권,SK,18,0,0,0,-,0,0
2019,신재웅,SK,1,0,0,0,-,0,0
2019,오준혁,SK,2,0,0,0,-,0,0
2019,이승진,SK,1,0,0,0,-,0,0
2019,이현석,SK,2,0,0,0,-,0,0
2019,임재현,SK,6,0,0,0,-,0,0
2019,정의윤,SK,110,0,0,0,-,3,1
2019,정진기,SK,13,0,0,0,-,0,0
2019,최경모,SK,17,0,0,0,-,0,0
2019,최민재,SK,1,0,0,0,-,0,0
2019,최승준,SK,10,0,0,0,-,0,0
2019,최준우,SK,15,0,0,0,-,0,0
2019,한동민,SK,125,1,0,1,0.0,8,0
2019,허도환,SK,56,1,0,1,0.0,1,0
2019,국해성,두산,21,0,0,0,-,0,0
2019,권혁,두산,1,0,0,0,-,0,0
2019,김경호,두산,32,0,0,0,-,0,0
2019,김대한,두산,19,0,0,0,-,0,0
2019,김승회,두산,1,0,0,0,-,0,0
2019,박유연,두산,2,0,0,0,-,0,0
2019,배영수,두산,2,0,0,0,-,0,0
2019,백동훈,두산,41,1,0,1,0.0,0,0
2019,서예일,두산,7,0,0,0,-,0,0
2019,송승환,두산,2,0,0,0,-,0,0
2019,신성현,두산,35,0,0,0,-,0,0
2019,이영하,두산,1,0,0,0,-,0,0
2019,이흥련,두산,27,0,0,0,-,1,0
2019,장승현,두산,35,0,0,0,-,0,0
2019,전민재,두산,2,0,0,0,-,0,0
2019,정병곤,두산,20,0,0,0,-,0,0
2019,최주환,두산,87,0,0,0,-,8,0
2019,함덕주,두산,1,0,0,0,-,0,0
2019,김경태,한화,1,0,0,0,-,0,0
2019,김인환,한화,18,0,0,0,-,1,0
2019,김종민,한화,10,0,0,0,-,0,0
2019,김종수,한화,1,0,0,0,-,0,0
2019,김창혁,한화,3,0,0,0,-,0,0
2019,김태연,한화,9,0,0,0,-,0,0
2019,박상언,한화,1,0,0,0,-,0,0
2019,박준혁,한화,4,0,0,0,-,0,0
2019,박한결,한화,9,1,0,1,0.0,0,0
2019,백창수,한화,16,0,0,0,-,0,0
2019,변우혁,한화,29,0,0,0,-,0,0
2019,서폴드,한화,1,0,0,0,-,0,0
2019,신정락,한화,1,0,0,0,-,0,0
2019,안영명,한화,1,0,0,0,-,0,0
2019,이창열,한화,11,0,0,0,-,0,0
2019,임준섭,한화,2,0,0,0,-,0,0
2019,장운호,한화,7,1,0,1,0.0,0,0
2019,정우람,한화,4,0,0,0,-,0,0
2019,지성준,한화,58,0,0,0,-,0,0
2019,최윤석,한화,7,0,0,0,-,0,0
2019,최진행,한화,45,0,0,0,-,1,0
2019,하주석,한화,5,0,0,0,-,0,0
2019,김웅빈,키움,4,0,0,0,-,0,0
2019,김은성,키움,5,0,0,0,-,0,0
2019,김주형,키움,3,0,0,0,-,0,0
2019,김지수,키움,69,0,0,0,-,1,0
2019,박병호,키움,122,1,0,1,0.0,2,0
2019,예진원,키움,2,0,0,0,-,0,0
2019,윤영삼,키움,1,0,0,0,-,0,0
2019,임지열,키움,11,0,0,0,-,0,0
2019,장영석,키움,119,0,0,0,-,2,0
2019,주효상,키움,18,0,0,0,-,1,0
2019,추재현,키움,1,0,0,0,-,0,0
2019,허정협,키움,37,0,0,0,-,0,0
2019,고영창,KIA,1,0,0,0,-,0,0
2019,고장혁,KIA,22,1,0,1,0.0,0,0
2019,김세현,KIA,1,0,0,0,-,0,0
2019,나지완,KIA,56,0,0,0,-,0,0
2019,문경찬,KIA,2,0,0,0,-,0,0
2019,백용환,KIA,28,0,0,0,-,0,0
2019,신범수,KIA,39,0,0,0,-,0,0
2019,양승철,KIA,1,0,0,0,-,0,0
2019,오선우,KIA,27,0,0,0,-,0,0
2019,오정환,KIA,30,2,0,2,0.0,1,0
2019,유민상,KIA,61,0,0,0,-,4,0
2019,윤해진,KIA,2,0,0,0,-,0,0
2019,이민우,KIA,1,0,0,0,-,0,0
2019,이범호,KIA,19,0,0,0,-,0,0
2019,이우성,KIA,60,0,0,0,-,0,0
2019,이인행,KIA,9,0,0,0,-,0,0
2019,이정훈,KIA,7,0,0,0,-,0,0
2019,이진영,KIA,11,0,0,0,-,0,0
2019,임기준,KIA,1,0,0,0,-,0,0
2019,장지수,KIA,1,0,0,0,-,0,0
2019,전상현,KIA,1,0,0,0,-,0,0
2019,최정민,KIA,4,0,0,0,-,1,0
2019,최정용,KIA,8,0,0,0,-,0,0
2019,최형우,KIA,136,1,0,1,0.0,6,0
2019,터커,KIA,95,0,0,0,-,3,0
2019,한준수,KIA,7,0,0,0,-,1,0
2019,홍재호,KIA,10,0,0,0,-,0,0
2019,황대인,KIA,12,0,0,0,-,1,0
2019,강민호,삼성,112,0,0,0,-,2,1
2019,공민규,삼성,28,0,0,0,-,0,0
2019,권오준,삼성,2,0,0,0,-,0,0
2019,김도환,삼성,61,0,0,0,-,0,0
2019,김민수,삼성,29,0,0,0,-,0,0
2019,김응민,삼성,8,0,0,0,-,0,0
2019,김재현,삼성,6,0,0,0,-,0,0
2019,김호재,삼성,28,1,0,1,0.0,0,0
2019,박찬도,삼성,30,1,0,1,0.0,0,0
2019,박한이,삼성,30,0,0,0,-,0,0
2019,백승민,삼성,19,0,0,0,-,0,0
2019,손주인,삼성,20,1,0,1,0.0,1,0
2019,송준석,삼성,26,0,0,0,-,1,0
2019,양우현,삼성,1,0,0,0,-,0,0
2019,윌리엄슨,삼성,40,1,0,1,0.0,1,0
2019,이성곤,삼성,13,0,0,0,-,1,0
2019,이현동,삼성,1,0,0,0,-,0,0
2019,최지광,삼성,1,0,0,0,-,0,0
2019,고승민,롯데,30,0,0,0,-,2,0
2019,고효준,롯데,1,0,0,0,-,0,0
2019,구승민,롯데,2,0,0,0,-,0,0
2019,김민수,롯데,11,0,0,0,-,1,0
2019,김사훈,롯데,3,0,0,0,-,0,0
2019,김준태,롯데,43,0,0,0,-,4,0
2019,나종덕,롯데,104,0,0,0,-,1,0
2019,문규현,롯데,40,0,0,0,-,2,0
2019,박시영,롯데,3,0,0,0,-,0,0
2019,박진형,롯데,2,0,0,0,-,0,0
2019,손승락,롯데,2,0,0,0,-,0,0
2019,신용수,롯데,17,0,0,0,-,0,0
2019,안중열,롯데,73,1,0,1,0.0,1,1
2019,오윤석,롯데,76,0,0,0,-,1,1
2019,오현택,롯데,1,0,0,0,-,0,0
2019,이대호,롯데,135,0,0,0,-,3,0
2019,이병규,롯데,8,0,0,0,-,0,0
2019,이찬건,롯데,2,0,0,0,-,0,0
2019,전병우,롯데,29,0,0,0,-,1,0
2019,정보근,롯데,15,0,0,0,-,0,0
2019,정성종,롯데,2,0,0,0,-,0,0
2019,정준혁,롯데,6,0,0,0,-,0,0
2019,채태인,롯데,59,0,0,0,-,0,0
2019,최영환,롯데,1,0,0,0,-,0,0
2019,황진수,롯데,6,0,0,0,-,0,0
2019,고우석,LG,1,0,0,0,-,0,0
2019,김재성,LG,3,0,0,0,-,0,0
2019,김재율,LG,4,0,0,0,-,0,0
2019,류형우,LG,10,0,0,0,-,0,0
2019,문광은,LG,2,0,0,0,-,0,0
2019,박지규,LG,10,0,0,0,-,0,0
2019,서상우,LG,13,0,0,0,-,1,0
2019,양원혁,LG,1,0,0,0,-,0,0
2019,양종민,LG,18,0,0,0,-,1,0
2019,여건욱,LG,3,0,0,0,-,0,0
2019,유강남,LG,132,0,0,0,-,8,0
2019,이상영,LG,1,0,0,0,-,0,0
2019,이성우,LG,55,0,0,0,-,1,0
2019,장원삼,LG,1,0,0,0,-,0,0
2019,전준호,LG,8,0,0,0,-,0,0
2019,정상호,LG,22,0,0,0,-,0,0
2019,정우영,LG,1,0,0,0,-,0,0
2019,정찬헌,LG,1,0,0,0,-,0,0
2019,조셉,LG,55,1,0,1,0.0,0,0
2019,최동환,LG,2,0,0,0,-,0,0
2019,고명성,KT,30,0,0,0,-,1,1
2019,김병희,KT,4,0,0,0,-,0,0
2019,김영환,KT,13,0,0,0,-,0,0
2019,김재윤,KT,3,0,0,0,-,0,0
2019,박경수,KT,137,1,0,1,0.0,1,0
2019,박민석,KT,3,0,0,0,-,0,0
2019,배정대,KT,66,2,0,2,0.0,1,0
2019,손동현,KT,2,0,0,0,-,0,0
2019,안승한,KT,36,0,0,0,-,1,0
2019,안치영,KT,5,0,0,0,-,0,0
2019,엄상백,KT,1,0,0,0,-,0,0
2019,윤석민,KT,63,0,0,0,-,1,0
2019,이대은,KT,4,0,0,0,-,0,0
2019,이대형,KT,18,0,0,0,-,1,0
2019,이준수,KT,32,0,0,0,-,2,0
2019,이해창,KT,30,0,0,0,-,0,0
2019,장성우,KT,127,1,0,1,0.0,6,0
2019,정성곤,KT,2,0,0,0,-,0,0
2019,주권,KT,1,0,0,0,-,0,0
2019,하준호,KT,1,0,0,0,-,0,0
2019,강윤구,NC,1,0,0,0,-,0,0
2019,김건태,NC,1,0,0,0,-,0,0
2019,김영규,NC,1,0,0,0,-,0,0
2019,김준완,NC,8,0,0,0,-,0,1
2019,김진성,NC,3,0,0,0,-,0,0
2019,김진형,NC,11,0,0,0,-,0,0
2019,김철호,NC,2,0,0,0,-,0,0
2019,김태군,NC,18,0,0,0,-,0,0
2019,김형준,NC,55,0,0,0,-,3,0
2019,노진혁,NC,110,1,0,1,0.0,2,0
2019,민태호,NC,1,0,0,0,-,0,0
2019,박헌욱,NC,6,0,0,0,-,0,0
2019,배재환,NC,2,0,0,0,-,0,0
2019,오영수,NC,3,0,0,0,-,0,0
2019,원종현,NC,6,0,0,0,-,0,0
2019,유영준,NC,3,0,0,0,-,0,0
2019,유원상,NC,3,0,0,0,-,0,0
2019,윤수강,NC,2,0,0,0,-,0,0
2019,윤지웅,NC,1,0,0,0,-,0,0
2019,이우석,NC,1,0,0,0,-,0,0
2019,이인혁,NC,6,0,0,0,-,0,0
2019,전사민,NC,1,0,0,0,-,0,0
2019,지석훈,NC,76,1,0,1,0.0,5,0
2019,최성영,NC,1,0,0,0,-,0,0
2019,홍성무,NC,2,0,0,0,-,0,0
2020,심우준,KT,144,46,35,11,76.1,3,1
2020,박해민,삼성,132,46,34,12,73.9,5,3
2020,김혜성,키움,142,33,25,8,75.8,3,2
2020,서건창,키움,135,34,24,10,70.6,9,1
2020,김하성,키움,138,25,23,2,92.0,6,0
2020,알테어,NC,136,25,22,3,88.0,4,2
2020,배정대,KT,144,35,22,13,62.9,4,2
2020,김지찬,삼성,135,25,21,4,84.0,1,2
2020,오지환,LG,141,28,20,8,71.4,9,1
2020,구자욱,삼성,118,24,19,5,79.2,4,2
2020,최지훈,SK,127,24,18,6,75.0,3,3
2020,이용규,한화,120,25,17,8,68.0,5,1
2020,정수빈,두산,141,21,15,6,71.4,6,0
2020,오태곤,SK,94,21,15,6,71.4,1,2
2020,박찬호,KIA,141,23,15,8,65.2,3,0
2020,마차도,롯데,144,16,15,1,93.8,7,0
2020,허경민,두산,117,20,14,6,70.0,4,1
2020,최원준,KIA,123,17,14,3,82.4,5,2
2020,안치홍,롯데,124,17,14,3,82.4,4,0
2020,이유찬,두산,101,17,13,4,76.5,2,0
2020,박민우,NC,126,19,13,6,68.4,5,1
2020,이정후,키움,140,14,12,2,85.7,3,1
2020,김성욱,NC,104,17,12,5,70.6,2,0
2020,이명기,NC,136,19,12,7,63.2,5,1
2020,조용호,KT,132,15,12,3,80.0,4,1
2020,홍창기,LG,135,16,11,5,68.8,4,1
2020,황재균,KT,134,17,11,6,64.7,3,1
2020,노수광,한화,100,18,11,7,61.1,4,0
2020,정훈,롯데,111,12,11,1,91.7,2,0
2020,오재원,두산,85,15,10,5,66.7,3,1
2020,김상수,삼성,120,13,10,3,76.9,4,0
2020,김동한,롯데,82,14,10,4,71.4,3,0
2020,김재유,롯데,68,12,10,2,83.3,1,1
2020,민병헌,롯데,109,16,10,6,62.5,2,0
2020,박정음,키움,86,10,9,1,90.0,0,1
2020,강진성,NC,121,10,9,1,90.0,3,1
2020,정진호,한화,113,16,9,7,56.3,2,0
2020,박건우,두산,129,10,8,2,80.0,4,1
2020,최정,SK,133,11,8,3,72.7,6,2
2020,신민재,LG,68,10,8,2,80.0,1,0
2020,이천웅,LG,89,13,8,5,61.5,7,0
2020,정주현,LG,134,15,8,7,53.3,7,1
2020,김민혁,KT,108,12,8,4,66.7,2,0
2020,전병우,키움,119,7,7,0,100.0,3,0
2020,김강민,SK,122,12,7,5,58.3,2,1
2020,김창평,SK,35,7,7,0,100.0,1,1
2020,정진기,SK,50,8,7,1,87.5,1,1
2020,김용의,LG,101,10,7,3,70.0,1,0
2020,정근우,LG,72,9,7,2,77.8,2,0
2020,강백호,KT,129,9,7,2,77.8,10,0
2020,김태진,KIA,82,11,7,4,63.6,3,0
2020,김헌곤,삼성,97,12,7,5,58.3,2,0
2020,김재호,두산,120,8,6,2,75.0,6,0
2020,김재환,두산,140,6,6,0,100.0,2,0
2020,이상호,NC,82,10,6,4,60.0,0,1
2020,살라디노,삼성,44,7,6,1,85.7,2,1
2020,이학주,삼성,64,8,6,2,75.0,2,1
2020,박세혁,두산,124,8,5,3,62.5,6,0
2020,박준태,키움,128,6,5,1,83.3,4,3
2020,손호영,LG,23,5,5,0,100.0,1,0
2020,양의지,NC,130,7,5,2,71.4,4,0
2020,박승욱,KT,97,6,5,1,83.3,2,1
2020,박찬도,삼성,51,6,5,1,83.3,3,0
2020,호잉,한화,34,8,5,3,62.5,2,0
2020,손아섭,롯데,141,5,5,0,100.0,4,0
2020,전준우,롯데,143,10,5,5,50.0,5,0
2020,로맥,SK,139,6,4,2,66.7,5,0
2020,이재율,NC,25,5,4,1,80.0,0,0
2020,최정원,NC,49,4,4,0,100.0,1,1
2020,송민섭,KT,114,7,4,3,57.1,2,0
2020,김동엽,삼성,115,8,4,4,50.0,0,2
2020,박승규,삼성,91,9,4,5,44.4,1,0
2020,하주석,한화,72,5,4,1,80.0,3,0
2020,조수행,두산,44,5,3,2,60.0,0,0
2020,임병욱,키움,12,3,3,0,100.0,0,0
2020,채현우,SK,16,3,3,0,100.0,0,0
2020,권희동,NC,123,3,3,0,100.0,0,0
2020,김찬형,NC,56,4,3,1,75.0,2,0
2020,나성범,NC,130,4,3,1,75.0,2,0
2020,김호령,KIA,89,6,3,3,50.0,1,0
2020,박계범,삼성,80,5,3,2,60.0,2,0
2020,이성규,삼성,98,4,3,1,75.0,3,0
2020,안권수,두산,68,3,2,1,66.7,4,0
2020,오재일,두산,127,3,2,1,66.7,7,0
2020,최주환,두산,140,4,2,2,50.0,5,0
2020,러셀,키움,65,2,2,0,100.0,3,1
2020,한동민,SK,62,2,2,0,100.0,2,0
2020,김민성,LG,87,3,2,1,66.7,2,0
2020,라모스,LG,117,2,2,0,100.0,4,0
2020,박용택,LG,97,2,2,0,100.0,1,0
2020,김규성,KIA,103,3,2,1,66.7,3,2
2020,황윤호,KIA,25,2,2,0,100.0,0,0
2020,김호재,삼성,65,2,2,0,100.0,2,0
2020,이성곤,삼성,62,2,2,0,100.0,2,1
2020,최영진,삼성,58,5,2,3,40.0,0,0
2020,팔카,삼성,51,2,2,0,100.0,2,0
2020,반즈,한화,74,3,2,1,66.7,0,0
2020,장진혁,한화,19,3,2,1,66.7,1,1
2020,강로한,롯데,16,3,2,1,66.7,0,1
2020,김준태,롯데,128,4,2,2,50.0,8,1
2020,오윤석,롯데,63,3,2,1,66.7,0,0
2020,국해성,두산,46,2,1,1,50.0,0,0
2020,권민석,두산,55,1,1,0,100.0,0,0
2020,김규민,키움,54,1,1,0,100.0,1,0
2020,김웅빈,키움,73,1,1,0,100.0,1,1
2020,이지영,키움,101,2,1,1,50.0,2,0
2020,고종욱,SK,92,4,1,3,25.0,2,1
2020,김경호,SK,56,5,1,4,20.0,0,0
2020,김민준,SK,12,2,1,1,50.0,0,1
2020,김성현,SK,133,2,1,1,50.0,6,1
2020,박성한,SK,41,2,1,1,50.0,0,1
2020,유서준,SK,28,2,1,1,50.0,0,0
2020,이현석,SK,58,1,1,0,100.0,0,1
2020,최준우,SK,66,2,1,1,50.0,2,0
2020,최항,SK,47,1,1,0,100.0,1,0
2020,유강남,LG,137,2,1,1,50.0,3,0
2020,이형종,LG,81,1,1,0,100.0,4,0
2020,한석현,LG,9,1,1,0,100.0,0,0
2020,박준영,NC,32,1,1,0,100.0,0,0
2020,이원재,NC,73,1,1,0,100.0,2,0
2020,지석훈,NC,87,1,1,0,100,1,0
2020,천성호,KT,66,2,1,1,50.0,1,0
2020,김선빈,KIA,85,2,1,1,50.0,3,0
2020,김영환,KIA,14,2,1,1,50.0,0,0
2020,류지혁,KIA,25,2,1,1,50.0,0,0
2020,이우성,KIA,48,1,1,0,100,0,0
2020,이진영,KIA,32,1,1,0,100,0,0
2020,최정민,KIA,24,1,1,0,100,1,1
2020,강한울,삼성,34,1,1,0,100,0,0
2020,김성표,삼성,15,1,1,0,100,0,0
2020,강경학,한화,94,3,1,2,33.3,3,1
2020,이성열,한화,79,2,1,1,50.0,2,0
2020,정은원,한화,79,2,1,1,50.0,5,0
2020,김민수,롯데,3,1,1,0,100,0,0
2020,신본기,롯데,81,1,1,0,100,0,0
2020,신용수,롯데,5,2,1,1,50.0,0,0
2020,이대호,롯데,144,1,1,0,100,7,0
2020,권휘,두산,1,0,0,0,-,0,0
2020,김강률,두산,2,0,0,0,-,0,0
2020,김민규,두산,3,0,0,0,-,0,0
2020,김인태,두산,77,0,0,0,-,0,0
2020,박지훈,두산,10,0,0,0,-,0,0
2020,백동훈,두산,27,0,0,0,-,0,0
2020,서예일,두산,40,0,0,0,-,0,0
2020,신성현,두산,9,0,0,0,-,0,0
2020,양찬열,두산,17,0,0,0,-,0,0
2020,오명진,두산,5,0,0,0,-,0,0
2020,윤명준,두산,1,0,0,0,-,0,0
2020,이승민,두산,3,0,0,0,-,0,0
2020,이영하,두산,1,0,0,0,-,0,0
2020,이형범,두산,1,0,0,0,-,0,0
2020,장승현,두산,23,0,0,0,-,0,0
2020,정상호,두산,42,0,0,0,-,0,1
2020,조제영,두산,1,0,0,0,-,0,0
2020,최용제,두산,28,0,0,0,-,0,0
2020,페르난데스,두산,144,1,0,1,0.0,9,0
2020,함덕주,두산,2,0,0,0,-,0,0
2020,홍건희,두산,1,0,0,0,-,0,0
2020,김동혁,키움,1,0,0,0,-,0,0
2020,김병휘,키움,1,0,0,0,-,0,0
2020,김상수,키움,1,0,0,0,-,0,0
2020,김성민,키움,3,0,0,0,-,0,0
2020,김수환,키움,9,0,0,0,-,1,0
2020,김은성,키움,16,0,0,0,-,0,0
2020,김재웅,키움,2,0,0,0,-,0,0
2020,김재현,키움,4,0,0,0,-,0,0
2020,김주형,키움,39,1,0,1,0.0,0,0
2020,모터,키움,10,0,0,0,-,0,0
2020,문찬종,키움,5,0,0,0,-,0,0
2020,박동원,키움,112,0,0,0,-,0,0
2020,박병호,키움,93,0,0,0,-,1,1
2020,박주홍,키움,13,1,0,1,0.0,1,0
2020,변상권,키움,35,0,0,0,-,0,0
2020,송우현,키움,14,0,0,0,-,0,0
2020,신재영,키움,1,0,0,0,-,0,0
2020,안우진,키움,1,0,0,0,-,0,0
2020,양기현,키움,1,0,0,0,-,0,0
2020,양현,키움,1,0,0,0,-,0,0
2020,윤정현,키움,2,0,0,0,-,0,0
2020,이택근,키움,20,0,0,0,-,0,0
2020,임규빈,키움,2,0,0,0,-,0,0
2020,임지열,키움,1,0,0,0,-,0,0
2020,조상우,키움,6,0,0,0,-,0,0
2020,조성운,키움,4,0,0,0,-,0,0
2020,조영건,키움,3,0,0,0,-,0,0
2020,주효상,키움,63,0,0,0,-,0,0
2020,허정협,키움,111,0,0,0,-,2,0
2020,김성민,SK,9,0,0,0,-,0,0
2020,김재현,SK,8,0,0,0,-,0,1
2020,김정빈,SK,4,0,0,0,-,0,0
2020,김주온,SK,2,0,0,0,-,0,0
2020,김주한,SK,1,0,0,0,-,0,0
2020,김태훈,SK,2,0,0,0,-,0,0
2020,남태혁,SK,35,0,0,0,-,0,0
2020,류효승,SK,8,0,0,0,-,0,0
2020,박민호,SK,4,0,0,0,-,0,0
2020,박종훈,SK,1,0,0,0,-,0,0
2020,서동민,SK,3,0,0,0,-,0,0
2020,서진용,SK,6,0,0,0,-,0,0
2020,신재웅,SK,1,0,0,0,-,0,0
2020,오원석,SK,2,0,0,0,-,0,0
2020,오준혁,SK,70,3,0,3,0.0,4,0
2020,윤석민,SK,34,0,0,0,-,1,0
2020,이거연,SK,8,0,0,0,-,0,0
2020,이재원,SK,80,0,0,0,-,1,0
2020,이흥련,SK,49,0,0,0,-,0,0
2020,정영일,SK,1,0,0,0,-,0,0
2020,정의윤,SK,76,1,0,1,0.0,2,0
2020,정현,SK,89,2,0,2,0.0,0,0
2020,조영우,SK,1,0,0,0,-,0,0
2020,채태인,SK,71,0,0,0,-,1,0
2020,하재훈,SK,1,0,0,0,-,0,0
2020,현원회,SK,1,0,0,0,-,0,0
2020,화이트,SK,9,0,0,0,-,1,0
2020,구본혁,LG,125,0,0,0,-,1,1
2020,김대현,LG,1,0,0,0,-,0,0
2020,김현수,LG,142,2,0,2,0.0,4,0
2020,김호은,LG,69,0,0,0,-,1,0
2020,남호,LG,1,0,0,0,-,0,0
2020,류원석,LG,1,0,0,0,-,0,0
2020,박재욱,LG,15,0,0,0,-,0,0
2020,박지규,LG,4,0,0,0,-,0,0
2020,백승현,LG,27,0,0,0,-,1,0
2020,백청훈,LG,1,0,0,0,-,0,0
2020,송은범,LG,4,0,0,0,-,0,0
2020,양석환,LG,40,0,0,0,-,1,0
2020,이성우,LG,72,0,0,0,-,3,0
2020,이우찬,LG,1,0,0,0,-,0,0
2020,이재원,LG,16,0,0,0,-,0,0
2020,이정용,LG,1,0,0,0,-,0,0
2020,이찬혁,LG,1,0,0,0,-,0,0
2020,장준원,LG,46,0,0,0,-,0,1
2020,전민수,LG,4,0,0,0,-,0,0
2020,정우영,LG,2,0,0,0,-,0,0
2020,진해수,LG,1,0,0,0,-,0,0
2020,채은성,LG,109,3,0,3,0.0,4,0
2020,최동환,LG,3,0,0,0,-,0,0
2020,최성훈,LG,3,0,0,0,-,0,0
2020,최재원,LG,6,0,0,0,-,0,0
2020,강동연,NC,3,0,0,0,-,0,0
2020,김건태,NC,5,0,0,0,-,0,0
2020,김기환,NC,4,0,0,0,-,0,0
2020,김준완,NC,45,0,0,0,-,1,0
2020,김진성,NC,2,0,0,0,-,0,0
2020,김태군,NC,80,0,0,0,-,1,0
2020,김형준,NC,44,0,0,0,-,2,0
2020,노진혁,NC,132,4,0,4,0.0,1,0
2020,도태훈,NC,11,0,0,0,-,0,0
2020,모창민,NC,62,0,0,0,-,1,0
2020,박석민,NC,123,1,0,1,0.0,5,0
2020,박시원,NC,1,0,0,0,-,0,0
2020,배민서,NC,1,0,0,0,-,0,0
2020,배재환,NC,1,0,0,0,-,0,0
2020,서호철,NC,2,0,0,0,-,0,0
2020,손정욱,NC,1,0,0,0,-,0,0
2020,송명기,NC,1,0,0,0,-,0,0
2020,원종현,NC,4,0,0,0,-,0,0
2020,유영준,NC,4,0,0,0,-,0,0
2020,윤수강,NC,4,0,0,0,-,0,0
2020,홍성무,NC,1,0,0,0,-,0,0
2020,강민국,KT,81,1,0,1,0.0,1,0
2020,강현우,KT,26,0,0,0,-,0,0
2020,김민,KT,2,0,0,0,-,0,0
2020,김민수,KT,1,0,0,0,-,0,0
2020,김병희,KT,29,0,0,0,-,0,0
2020,김성훈,KT,1,0,0,0,-,0,0
2020,김재윤,KT,2,0,0,0,-,0,0
2020,김태훈,KT,2,0,0,0,-,0,0
2020,로하스,KT,142,1,0,1,0.0,7,0
2020,류희운,KT,1,0,0,0,-,0,0
2020,문상인,KT,3,0,0,0,-,0,0
2020,문상철,KT,74,1,0,1,0.0,1,0
2020,박경수,KT,119,1,0,1,0.0,5,0
2020,박준혁,KT,12,0,0,0,-,0,0
2020,안현준,KT,1,0,0,0,-,0,0
2020,유원상,KT,1,0,0,0,-,0,0
2020,유한준,KT,119,0,0,0,-,2,0
2020,이대은,KT,2,0,0,0,-,0,0
2020,이보근,KT,1,0,0,0,-,0,0
2020,이상화,KT,1,0,0,0,-,0,0
2020,이창재,KT,1,0,0,0,-,0,0
2020,이홍구,KT,49,0,0,0,-,2,0
2020,장성우,KT,130,0,0,0,-,1,0
2020,전유수,KT,2,0,0,0,-,0,0
2020,정주후,KT,10,1,0,1,0.0,0,0
2020,조병욱,KT,1,0,0,0,-,0,0
2020,주권,KT,2,0,0,0,-,0,0
2020,허도환,KT,52,0,0,0,-,0,0
2020,홍현빈,KT,40,1,0,1,0.0,0,0
2020,고장혁,KIA,7,0,0,0,-,1,0
2020,김민식,KIA,69,0,0,0,-,3,0
2020,김주찬,KIA,7,1,0,1,0.0,0,0
2020,김현준,KIA,1,0,0,0,-,0,0
2020,나주환,KIA,64,0,0,0,-,1,0
2020,나지완,KIA,137,0,0,0,-,7,0
2020,문선재,KIA,15,0,0,0,-,2,0
2020,박민,KIA,6,0,0,0,-,0,0
2020,백용환,KIA,52,0,0,0,-,0,0
2020,오선우,KIA,59,0,0,0,-,0,0
2020,유민상,KIA,126,0,0,0,-,4,0
2020,이정훈,KIA,3,0,0,0,-,0,0
2020,이창진,KIA,22,1,0,1,0.0,2,1
2020,장영석,KIA,11,0,0,0,-,0,0
2020,장현식,KIA,1,0,0,0,-,0,0
2020,최정용,KIA,38,0,0,0,-,0,0
2020,최형우,KIA,140,0,0,0,-,3,0
2020,터커,KIA,142,2,0,2,0.0,3,0
2020,한승택,KIA,83,0,0,0,-,2,0
2020,홍종표,KIA,40,2,0,2,0.0,1,0
2020,황대인,KIA,63,0,0,0,-,1,0
2020,강민호,삼성,119,0,0,0,-,2,0
2020,권정웅,삼성,3,0,0,0,-,0,0
2020,김대우,삼성,1,0,0,0,-,0,0
2020,김도환,삼성,34,0,0,0,-,1,0
2020,김민수,삼성,17,0,0,0,-,0,0
2020,김성윤,삼성,9,0,0,0,-,0,1
2020,김응민,삼성,45,0,0,0,-,2,0
2020,김재현,삼성,35,0,0,0,-,0,0
2020,라이블리,삼성,1,0,0,0,-,0,0
2020,백승민,삼성,7,0,0,0,-,0,0
2020,송준석,삼성,32,0,0,0,-,1,0
2020,양우현,삼성,7,0,0,0,-,0,0
2020,양창섭,삼성,1,0,0,0,-,0,0
2020,이원석,삼성,121,1,0,1,0.0,1,1
2020,임현준,삼성,1,0,0,0,-,0,0
2020,장지훈,삼성,1,0,0,0,-,0,0
2020,홍정우,삼성,1,0,0,0,-,0,0
2020,김문호,한화,18,0,0,0,-,0,0
2020,김민하,한화,36,0,0,0,-,1,0
2020,김지수,한화,14,0,0,0,-,0,0
2020,김진욱,한화,1,0,0,0,-,0,0
2020,김태균,한화,67,0,0,0,-,0,0
2020,김현민,한화,4,0,0,0,-,0,0
2020,김회성,한화,15,0,0,0,-,0,0
2020,노시환,한화,106,1,0,1,0.0,1,0
2020,노태형,한화,55,1,0,1,0.0,1,0
2020,박상언,한화,38,0,0,0,-,0,0
2020,박정현,한화,30,0,0,0,-,2,0
2020,박한결,한화,13,0,0,0,-,0,0
2020,송광민,한화,94,0,0,0,-,1,0
2020,양성우,한화,5,0,0,0,-,0,0
2020,오선진,한화,93,1,0,1,0.0,1,0
2020,유장혁,한화,30,1,0,1,0.0,1,0
2020,이도윤,한화,14,0,0,0,-,0,0
2020,이동훈,한화,37,0,0,0,-,1,0
2020,이해창,한화,70,2,0,2,0.0,2,0
2020,임종찬,한화,52,1,0,1,0.0,1,1
2020,장운호,한화,24,0,0,0,-,0,0
2020,정기훈,한화,29,1,0,1,0.0,0,0
2020,정우람,한화,1,0,0,0,-,0,0
2020,조한민,한화,25,0,0,0,-,0,0
2020,최승준,한화,2,0,0,0,-,0,0
2020,최인호,한화,47,0,0,0,-,0,0
2020,최재훈,한화,126,0,0,0,-,3,0
2020,최진행,한화,84,0,0,0,-,0,0
2020,허관회,한화,1,0,0,0,-,1,0
2020,강태율,롯데,14,0,0,0,-,0,0
2020,고효준,롯데,1,0,0,0,-,0,0
2020,구승민,롯데,1,0,0,0,-,0,0
2020,김강현,롯데,5,0,0,0,-,0,0
2020,김대우,롯데,1,0,0,0,-,0,0
2020,김원중,롯데,3,0,0,0,-,0,0
2020,배성근,롯데,4,1,0,1,0.0,0,0
2020,오현택,롯데,1,0,0,0,-,0,0
2020,이병규,롯데,53,0,0,0,-,0,0
2020,이인복,롯데,2,0,0,0,-,0,0
2020,이호연,롯데,1,0,0,0,-,0,0
2020,정보근,롯데,85,0,0,0,-,3,0
2020,지성준,롯데,3,0,0,0,-,0,0
2020,진명호,롯데,1,0,0,0,-,0,0
2020,추재현,롯데,13,0,0,0,-,0,0
2020,한동희,롯데,135,3,0,3,0.0,5,0
2020,허일,롯데,60,0,0,0,-,1,0
